Release Date,Movie Title,Production Budget,Domestic Gross,Worldwide Gross,Profit,Profit%
4/23/2019,Avengers: Endgame,400000000,858373000,2797800564,2397800564,5.9945
5/20/2011,Pirates of the Caribbean: On Stranger Tides,379000000,241071802,1045713802,666713802,1.75914
4/22/2015,Avengers: Age of Ultron,365000000,459005868,1395316979,1030316979,2.82279
12/16/2015,Star Wars Ep. VII: The Force Awakens,306000000,936662225,2064615817,1758615817,5.74711
4/25/2018,Avengers: Infinity War,300000000,678815482,2044540523,1744540523,5.81514
5/24/2007,Pirates of the Caribbean: At World’s End,300000000,309420425,960996492,660996492,2.20332
11/13/2017,Justice League,300000000,229024295,655945209,355945209,1.18648
10/6/2015,Spectre,300000000,200074175,879500760,579500760,1.93167
12/18/2019,Star Wars: The Rise of Skywalker,275000000,515202542,1072848487,797848487,2.90127
5/23/2018,Solo: A Star Wars Story,275000000,213767512,393151347,118151347,0.429641
3/7/2012,John Carter,263700000,73058679,282778100,19078100,0.0723477
3/23/2016,Batman v Superman: Dawn of Justice,263000000,330360194,872395091,609395091,2.31709
12/13/2017,Star Wars Ep. VIII: The Last Jedi,262000000,620181382,1331635141,1069635141,4.08258
7/11/2019,The Lion King,260000000,543638043,1654367425,1394367425,5.36295
11/24/2010,Tangled,260000000,200821936,584899819,324899819,1.24961
5/4/2007,Spider-Man 3,258000000,336530303,894860230,636860230,2.46845
4/22/2016,Captain America: Civil War,250000000,408084349,1151918521,901918521,3.60767
7/15/2009,Harry Potter and the Half-Blood Prince,250000000,302089278,929411069,679411069,2.71764
12/12/2013,The Hobbit: The Desolation of Smaug,250000000,258241522,959358436,709358436,2.83743
12/10/2014,The Hobbit: The Battle of the Five Armies,250000000,255119788,940389558,690389558,2.76156
4/7/2017,The Fate of the Furious,250000000,225764765,1236703796,986703796,3.94682
9/29/2021,No Time to Die,250000000,159740451,761155836,511155836,2.04462
12/17/2009,Avatar,237000000,760507625,2845899541,2608899541,11.008
6/28/2006,Superman Returns,232000000,200120000,391081192,159081192,0.685695
7/19/2012,The Dark Knight Rises,230000000,448139099,1082228107,852228107,3.70534
5/23/2017,Pirates of the Caribbean: Dead Men Tell No Tales,230000000,172558876,794861794,564861794,2.45592
11/14/2008,Quantum of Solace,230000000,169368427,591692078,361692078,1.57257
4/25/2012,The Avengers,225000000,623357910,1515100211,1290100211,5.73378
7/6/2006,Pirates of the Caribbean: Dead Man’s Chest,225000000,423315812,1066179725,841179725,3.73858
6/14/2013,Man of Steel,225000000,291045518,667999518,442999518,1.96889
5/16/2008,The Chronicles of Narnia: Prince Caspian,225000000,141621490,417341288,192341288,0.85485
7/2/2013,The Lone Ranger,225000000,89302115,260002115,35002115,0.155565
6/27/2012,The Amazing Spider-Man,220000000,262030663,757890267,537890267,2.44496
4/11/2012,Battleship,220000000,65233400,313477717,93477717,0.424899
6/20/2017,Transformers: The Last Knight,217000000,130168683,602893340,385893340,1.77831
6/9/2015,Jurassic World,215000000,652306625,1669979967,1454979967,6.76735
5/23/2012,Men in Black 3,215000000,179020854,654213485,439213485,2.04285
6/24/2009,Transformers: Revenge of the Fallen,210000000,402111870,836519699,626519699,2.98343
6/25/2014,Transformers: Age of Extinction,210000000,245439076,1104054072,894054072,4.2574
5/26/2006,X-Men: The Last Stand,210000000,234362462,459260946,249260946,1.18696
5/14/2010,Robin Hood,210000000,105487148,322459006,112459006,0.535519
12/14/2005,King Kong,207000000,218080025,550517357,343517357,1.6595
12/7/2007,The Golden Compass,205000000,70107728,367262558,162262558,0.791525
8/26/2020,Tenet,205000000,58456624,362403476,157403476,0.767822
2/13/2018,Black Panther,200000000,700059566,1336494321,1136494321,5.68247
12/18/1997,Titanic,200000000,659363944,2207986545,2007986545,10.0399
6/15/2018,Incredibles 2,200000000,608581744,1242805359,1042805359,5.21403
12/14/2016,Rogue One: A Star Wars Story,200000000,532177324,1055135598,855135598,4.27568
6/16/2016,Finding Dory,200000000,486295561,1025006125,825006125,4.12503
6/20/2019,Toy Story 4,200000000,434038008,1073080329,873080329,4.3654
6/18/2010,Toy Story 3,200000000,415004880,1068879522,868879522,4.3444
4/24/2013,Iron Man 3,200000000,408992272,1215392272,1015392272,5.07696
4/28/2017,Guardians of the Galaxy Vol 2,200000000,389813101,869113101,669113101,3.34557
6/30/2004,Spider-Man 2,200000000,373524485,794697557,594697557,2.97349
3/4/2010,Alice in Wonderland,200000000,334191110,1025491110,825491110,4.12746
10/26/2012,Skyfall,200000000,304360277,1110526981,910526981,4.55263
12/11/2012,The Hobbit: An Unexpected Journey,200000000,303003568,1014938545,814938545,4.07469
6/21/2013,Monsters University,200000000,268488329,743455810,543455810,2.71728
3/8/2013,Oz the Great and Powerful,200000000,234770996,490359051,290359051,1.4518
5/21/2014,X-Men: Days of Future Past,200000000,233921534,747862775,547862775,2.73931
4/16/2014,The Amazing Spider-Man 2,200000000,202853933,708996336,508996336,2.54498
6/23/2011,Cars 2,200000000,191450875,560155383,360155383,1.80078
7/7/2021,Black Widow,200000000,183651655,375620803,175620803,0.878104
7/31/2019,Fast & Furious Presents: Hobbs & Shaw,200000000,173956935,760381706,560381706,2.80191
12/17/2010,Tron: Legacy,200000000,172062763,399866199,199866199,0.999331
11/12/2009,2012,200000000,166112167,757677748,557677748,2.78839
11/14/2018,Fantastic Beasts: The Crimes of Grindelwald,200000000,159555901,651280475,451280475,2.2564
11/3/2021,Eternals,200000000,157435106,383781214,183781214,0.918906
5/21/2009,Terminator Salvation,200000000,125322469,365491792,165491792,0.827459
6/17/2011,Green Lantern,200000000,116601172,219535492,19535492,0.0976775
5/28/2010,Prince of Persia: Sands of Time,200000000,90759676,336359676,136359676,0.681798
6/5/2019,Dark Phoenix,200000000,65845974,246356895,46356895,0.231784
2/28/2020,Onward,200000000,61555145,133317030,-66682970,-0.333415
12/16/2020,Wonder Woman 1984,200000000,46586274,166145470,-33854530,-0.169273
9/4/2020,Mulan,200000000,0,69965374,-130034626,-0.650173
6/29/2011,Transformers: Dark of the Moon,195000000,352390543,1123794079,928794079,4.76305
6/2/2017,The Mummy,195000000,80101125,409953905,214953905,1.10233
2/27/2013,Jack the Giant Slayer,195000000,65187603,197687603,2687603,0.0137826
4/1/2015,Furious 7,190000000,353007020,1516881526,1326881526,6.98359
5/16/2013,Star Trek Into Darkness,190000000,228778661,467381584,277381584,1.4599
6/19/2013,World War Z,190000000,202706711,531861650,341861650,1.79927
5/10/2013,The Great Gatsby,190000000,144840419,353640419,163640419,0.861265
11/6/2009,Disney’s A Christmas Carol,190000000,137855863,315709697,125709697,0.66163
7/11/2013,Pacific Rim,190000000,101802906,411002906,221002906,1.16317
11/25/2015,The Good Dinosaur,187500000,123087120,333771037,146271037,0.780112
5/2/2008,Iron Man,186000000,318604126,585171547,399171547,2.14608
7/11/2008,The Dark Knight,185000000,533720947,998615789,813615789,4.39792
5/22/2008,Indiana Jones and the Kingdom of the Crystal Skull,185000000,317101119,786635413,601635413,3.25208
6/21/2012,Brave,185000000,237282182,554606532,369606532,1.99787
2/23/2017,Kong: Skull Island,185000000,168052812,561072059,376072059,2.03282
7/21/2016,Star Trek Beyond,185000000,158848340,335673708,150673708,0.814452
10/17/2019,Maleficent: Mistress of Evil,185000000,113929605,489346495,304346495,1.64512
9/29/2017,Blade Runner 2049,185000000,92054159,258829058,73829058,0.399076
10/25/2019,Terminator: Dark Fate,185000000,62253077,250372367,65372367,0.353364
7/28/2021,The Suicide Squad,185000000,55800219,167250021,-17749979,-0.0959458
5/22/2019,Aladdin,182000000,355559216,1046649706,864649706,4.75082
10/25/2017,Thor: Ragnarok,180000000,315058289,850482778,670482778,3.7249
12/9/2005,The Chronicles of Narnia: The Lion the Witch a…,180000000,291710957,720539572,540539572,3.003
5/28/2014,Maleficent,180000000,241407328,758536735,578536735,3.21409
11/14/2016,Fantastic Beasts and Where to Find Them,180000000,234037575,811724385,631724385,3.50958
6/27/2008,WALL-E,180000000,223808164,532508025,352508025,1.95838
8/10/2007,Rush Hour 3,180000000,140125968,256585882,76585882,0.425477
6/27/2016,The Legend of Tarzan,180000000,126643061,348902025,168902025,0.938345
11/23/2011,Hugo,180000000,73864507,180047784,47784,0.000265467
7/20/2017,Valerian and the City of a Thousand Planets,180000000,40479370,215098356,35098356,0.194991
2/6/2015,Jupiter Ascending,179000000,47482519,181982519,2982519,0.0166621
7/16/2018,Mission: Impossible—Fallout,178000000,220159104,787176729,609176729,3.42234
5/18/2016,X-Men: Apocalypse,178000000,155442489,542537546,364537546,2.04796
8/9/2018,The Meg,178000000,145443742,527370715,349370715,1.96276
5/28/2014,Edge of Tomorrow,178000000,100206256,367028980,189028980,1.06196
3/6/2019,Captain Marvel,175000000,426829839,1129727388,954727388,5.45559
4/7/2016,The Jungle Book,175000000,364001123,953554418,778554418,4.44888
6/12/2015,Inside Out,175000000,356461711,853641066,678641066,3.87795
7/5/2017,Spider-Man: Homecoming,175000000,334201140,880166350,705166350,4.02952
8/2/2016,Suicide Squad,175000000,325100054,745744980,570744980,3.2614
5/28/2009,Up,175000000,293004164,731463377,556463377,3.17979
10/27/2017,Coco,175000000,210460015,797666425,622666425,3.55809
11/21/2018,Ralph Breaks The Internet,175000000,201091711,529290830,354290830,2.02452
3/27/2009,Monsters vs. Aliens,175000000,198351526,381687380,206687380,1.18107
6/16/2017,Cars 3,175000000,152901115,383541369,208541369,1.19166
8/7/2009,G.I. Joe: The Rise of Cobra,175000000,150201498,302469017,127469017,0.728394
6/30/1999,Wild Wild West,175000000,113805681,221229335,46229335,0.264168
8/1/2008,The Mummy: Tomb of the Dragon Emperor,175000000,102491776,405760225,230760225,1.31863
6/22/2007,Evan Almighty,175000000,100289690,174131329,-868671,-0.00496383
7/28/1995,Waterworld,175000000,88246220,264246220,89246220,0.509978
1/8/2020,Dolittle,175000000,77047065,251409960,76409960,0.436628
5/11/2017,King Arthur: Legend of the Sword,175000000,39175066,139630336,-35369664,-0.202112
12/6/2013,47 Ronin,175000000,38362475,151716815,-23283185,-0.133047
6/6/2018,Jurassic World: Fallen Kingdom,170000000,417719760,1308334005,1138334005,6.69608
7/31/2014,Guardians of the Galaxy,170000000,333714112,770882395,600882395,3.5346
5/7/2010,Iron Man 2,170000000,312433331,621156389,451156389,2.65386
3/28/2014,Captain America: The Winter Soldier,170000000,259746958,714401889,544401889,3.20236
7/9/2014,Dawn of the Planet of the Apes,170000000,208545589,710644566,540644566,3.18026
11/10/2004,The Polar Express,170000000,188578855,312719437,142719437,0.839526
5/30/2012,Snow White and the Huntsman,170000000,155136755,401021746,231021746,1.35895
7/1/2003,Terminator 3: Rise of the Machines,170000000,150358296,433058296,263058296,1.5474
5/5/2004,Van Helsing,170000000,120150546,300150546,130150546,0.765591
3/27/2019,Dumbo,170000000,114766307,353166307,183166307,1.07745
5/29/2019,Godzilla: King of the Monsters,170000000,110500138,383299915,213299915,1.25471
5/20/2015,Tomorrowland,170000000,93436322,206627518,36627518,0.215456
2/1/2019,Alita: Battle Angel,170000000,85838210,401900040,231900040,1.36412
5/20/2016,Alice Through the Looking Glass,170000000,77042381,276928112,106928112,0.628989
5/21/2010,Shrek Forever After,165000000,238736787,756244673,591244673,3.5833
10/24/2016,Doctor Strange,165000000,232641920,676354481,511354481,3.09912
10/25/2014,Big Hero 6,165000000,222527828,649657407,484657407,2.93732
3/26/2010,How to Train Your Dragon,165000000,217581232,494870992,329870992,1.99922
11/1/2012,Wreck-It Ralph,165000000,189412677,496511521,331511521,2.00916
11/5/2014,Interstellar,165000000,188017894,651994868,486994868,2.95148
9/15/2021,Dune,165000000,105010871,383110871,218110871,1.32188
6/22/2016,Independence Day: Resurgence,165000000,103144286,384169424,219169424,1.3283
7/29/2011,Cowboys and Aliens,163000000,100368560,176038324,13038324,0.0799897
3/16/2017,Beauty and the Beast,160000000,504014165,1253802559,1093802559,6.83627
6/27/2019,Spider-Man: Far From Home,160000000,390532085,1131113066,971113066,6.06946
12/6/2018,Aquaman,160000000,335061807,1143758700,983758700,6.14849
5/17/2007,Shrek the Third,160000000,322719944,807330936,647330936,4.04582
7/16/2010,Inception,160000000,292576195,728582465,568582465,3.55364
11/18/2015,The Hunger Games: Mockingjay - Part 2,160000000,281723902,648986787,488986787,3.05617
5/17/2013,Fast and Furious 6,160000000,238679850,789300444,629300444,3.93313
5/14/2014,Godzilla,160000000,200676069,529076069,369076069,2.30673
6/3/2011,X-Men: First Class,160000000,146408305,355408305,195408305,1.2213
12/25/2008,The Curious Case of Benjamin Button,160000000,127509326,329631958,169631958,1.0602
7/14/2010,The Sorcerer's Apprentice,160000000,63150991,217986320,57986320,0.362414
5/12/2006,Poseidon,160000000,60674817,181674817,21674817,0.135468
5/25/2016,Warcraft,160000000,47365290,438899824,278899824,1.74312
11/1/2019,The Irishman,159000000,0,910234,-158089766,-0.994275
9/29/2016,Deepwater Horizon,156000000,61433527,122603824,-33396176,-0.214078
12/10/2010,The Chronicles of Narnia: The Voyage of the Daw…,155000000,104386950,418186950,263186950,1.69798
3/25/2021,Godzilla vs. Kong,155000000,100563133,467826620,312826620,2.01824
6/24/2015,Terminator: Genisys,155000000,89760956,432150894,277150894,1.78807
3/16/2018,Pacific Rim: Uprising,155000000,59874525,290930148,135930148,0.876969
11/24/2004,Alexander,155000000,34297191,167297191,12297191,0.0793367
7/14/2017,War for the Planet of the Apes,152000000,146880162,489592267,337592267,2.221
5/25/2001,Pearl Harbor,151500000,198539855,449239853,297739853,1.96528
7/2/2007,Transformers,151000000,319246193,708272592,557272592,3.69055
11/20/2019,Frozen II,150000000,477373578,1445182280,1295182280,8.63455
5/29/2017,Wonder Woman,150000000,412563408,818058221,668058221,4.45372
11/22/2013,Frozen,150000000,400953009,1265767173,1115767173,7.43845
2/10/2016,Zootopia,150000000,341268248,1004629935,854629935,5.69753
7/11/2007,Harry Potter and the Order of the Phoenix,150000000,292137260,940043931,790043931,5.26696
11/18/2005,Harry Potter and the Goblet of Fire,150000000,290201752,887070413,737070413,4.9138
5/15/2003,The Matrix Reloaded,150000000,281553689,738576929,588576929,3.92385
12/14/2007,I am Legend,150000000,256393010,585532684,435532684,2.90355
1/27/2016,Moana,150000000,248757044,634965560,484965560,3.2331
7/1/2008,Hancock,150000000,227946274,624234272,474234272,3.16156
9/1/2021,Shang-Chi and the Legend of the Ten Rings,150000000,224543292,418148439,268148439,1.78766
7/15/2005,Charlie and the Chocolate Factory,150000000,206459076,475825484,325825484,2.17217
6/29/2007,Ratatouille,150000000,206445654,626549695,476549695,3.177
10/30/2013,Thor: The Dark World,150000000,206362140,644602516,494602516,3.29735
6/15/2005,Batman Begins,150000000,205343774,358858124,208858124,1.39239
7/29/2015,Mission: Impossible—Rogue Nation,150000000,195042377,688858992,538858992,3.59239
7/18/2017,Dunkirk,150000000,190068280,519452014,369452014,2.46301
4/29/2011,Thor,150000000,181030624,449326618,299326618,1.99551
11/7/2008,Madagascar: Escape 2 Africa,150000000,180174880,599680774,449680774,2.99787
5/1/2009,X-Men Origins: Wolverine,150000000,179883157,374825760,224825760,1.49884
5/22/2009,Night at the Museum: Battle of the Smithsonian,150000000,177243721,402231063,252231063,1.68154
5/26/2011,Kung Fu Panda 2,150000000,165249063,664837547,514837547,3.43225
5/14/2015,Mad Max: Fury Road,150000000,153636354,367457874,217457874,1.44972
5/3/2019,Pokémon: Detective Pikachu,150000000,144105346,431482976,281482976,1.87655
11/5/2003,The Matrix Revolutions,150000000,139270910,427300260,277300260,1.84867
3/20/2018,Ready Player One,150000000,137690172,579055653,429055653,2.86037
11/4/2005,Chicken Little,150000000,135386665,310043823,160043823,1.06696
5/5/2006,Mission: Impossible III,150000000,133501348,399387745,249387745,1.66258
5/15/2009,Angels & Demons,150000000,133375846,490875846,340875846,2.27251
5/13/2004,Troy,150000000,133298577,483152040,333152040,2.22101
7/1/2010,The Last Airbender,150000000,131772187,319713881,169713881,1.13143
11/2/2007,Bee Movie,150000000,126631277,287594577,137594577,0.917297
7/24/2009,G-Force,150000000,119436770,292817841,142817841,0.952119
11/21/2008,Bolt,150000000,114053579,328015029,178015029,1.18677
3/28/2012,Wrath of the Titans,150000000,83670083,305270083,155270083,1.03513
11/16/2007,Beowulf,150000000,82280579,195080579,45080579,0.300537
5/9/2012,Dark Shadows,150000000,79727149,238202668,88202668,0.588018
6/28/2013,White House Down,150000000,73103784,205440387,55440387,0.369603
7/14/2021,Space Jam: A New Legacy,150000000,70528072,144032083,-5967917,-0.0397861
2/12/2010,The Wolfman,150000000,62189884,142634358,-7365642,-0.0491043
12/15/2016,The Great Wall,150000000,45157105,334486852,184486852,1.22991
9/25/2015,Pan,150000000,35088320,151525973,1525973,0.0101732
3/11/2011,Mars Needs Moms,150000000,21392758,39549758,-110450242,-0.736335
11/4/2021,Red Notice,150000000,0,173638,-149826362,-0.998842
2/3/2022,Moonfall,150000000,0,0,-150000000,-1
11/3/2006,Flushed Away,149000000,64665672,179357126,30357126,0.203739
6/8/2012,Madagascar 3: Europe's Most Wanted,145000000,216391482,746921271,601921271,4.15118
12/14/2011,Mission: Impossible—Ghost Protocol,145000000,209397903,694713230,549713230,3.79113
6/5/2014,How to Train Your Dragon 2,145000000,177002924,614586270,469586270,3.23853
6/16/1999,Tarzan,145000000,171091819,448191819,303191819,2.09098
2/20/2014,Mr. Peabody & Sherman,145000000,111506430,269806430,124806430,0.860734
11/20/2012,Rise of the Guardians,145000000,103412758,306900902,161900902,1.11656
4/8/2005,Sahara,145000000,68671925,121645390,-23354610,-0.161066
7/13/2016,Ghostbusters,144000000,128350574,229008658,85008658,0.590338
11/22/2002,Die Another Day,142000000,160942139,431942139,289942139,2.04185
7/9/2003,Pirates of the Caribbean: The Curse of the Blac…,140000000,305410819,654310819,514310819,3.67365
5/8/2009,Star Trek,140000000,257730019,386839614,246839614,1.76314
7/1/1998,Armageddon,140000000,201578182,554600000,414600000,2.96143
7/3/2002,Men in Black 2,140000000,190418803,441767803,301767803,2.15548
7/22/2011,Captain America: The First Avenger,140000000,176654505,370569776,230569776,1.64693
1/23/2016,Kung Fu Panda 3,140000000,143528619,521170825,381170825,2.72265
7/10/1998,Lethal Weapon 4,140000000,130444603,285400000,145400000,1.03857
3/27/2013,G.I. Joe: Retaliation,140000000,122523060,375740705,235740705,1.68386
12/5/2003,The Last Samurai,140000000,111110575,456810575,316810575,2.26293
12/21/2005,Fun With Dick And Jane,140000000,110550000,203018919,63018919,0.450135
12/5/2014,Exodus: Gods and Kings,140000000,65014513,268314513,128314513,0.916532
6/30/2016,The BFG,140000000,55483770,199646680,59646680,0.426048
10/3/2019,Gemini Man,140000000,48546770,166623705,26623705,0.190169
2/24/2016,Gods of Egypt,140000000,31153464,138836756,-1163244,-0.00830889
5/27/2022,Top Gun: Maverick,140000000,0,0,-140000000,-1
5/3/2002,Spider-Man,139000000,403706375,821706375,682706375,4.91156
3/6/2009,Watchmen,138000000,107509799,186976250,48976250,0.3549
7/29/2005,Stealth,138000000,32116746,76416746,-61583254,-0.446255
6/13/2008,The Incredible Hulk,137500000,134806913,265573859,128073859,0.931446
6/20/2003,Hulk,137000000,132177234,245031679,108031679,0.788552
7/11/2001,Final Fantasy: The Spirits Within,137000000,32131830,85131830,-51868170,-0.3786
11/14/2012,The Twilight Saga: Breaking Dawn Part 2,136200000,292324737,829724737,693524737,5.09196
3/15/2013,The Croods,135000000,187168425,573068425,438068425,3.24495
12/25/2015,The Revenant,135000000,183637894,532938302,397938302,2.94769
11/19/1999,The World is Not Enough,135000000,126930660,361730660,226730660,1.67949
3/4/2011,Rango,135000000,123477607,245724600,110724600,0.820182
11/14/2003,Master and Commander: The Far Side of the World,135000000,93926386,212912137,77912137,0.577127
7/17/2013,Turbo,135000000,83028130,286896578,151896578,1.12516
6/2/2016,Teenage Mutant Ninja Turtles: Out of the Shadows,135000000,82051601,245328374,110328374,0.817247
11/18/2011,Happy Feet Two,135000000,64006466,157956466,22956466,0.170048
7/28/2006,Miami Vice,135000000,63478838,164920076,29920076,0.22163
10/31/2018,The Nutcracker and the Four Realms,132900000,54858851,170024300,37124300,0.27934
6/24/2005,War of the Worlds,132000000,234280354,606836535,474836535,3.59725
11/26/2014,Penguins of Madagascar,132000000,83350911,366942531,234942531,1.77987
11/15/2013,The Hunger Games: Catching Fire,130000000,424668047,864868047,734868047,5.65283
5/31/2004,Harry Potter and the Prisoner of Azkaban,130000000,249757726,789592708,659592708,5.07379
8/3/2007,The Bourne Ultimatum,130000000,227471070,444043396,314043396,2.41572
7/3/2018,Ant-Man and the Wasp,130000000,216648740,623144660,493144660,3.79342
6/6/2008,Kung Fu Panda,130000000,215434591,631910531,501910531,3.86085
7/14/2015,Ant-Man,130000000,180202163,518858449,388858449,2.99122
3/19/2015,Home,130000000,177397510,385997896,255997896,1.96921
12/19/2018,Mary Poppins Returns,130000000,171958438,348901032,218901032,1.68385
10/28/2011,Puss in Boots,130000000,149260504,554987477,424987477,3.26913
11/5/2010,Megamind,130000000,148415853,321887208,191887208,1.47606
7/18/2003,Bad Boys II,130000000,138540870,273271982,143271982,1.10209
3/20/2014,Rio 2,130000000,131538435,492846291,362846291,2.79113
7/23/2010,Salt,130000000,118311368,290650494,160650494,1.23577
3/27/2014,Noah,130000000,101200044,352831065,222831065,1.71409
10/28/2011,The Adventures of Tintin,130000000,77591831,373993951,243993951,1.87688
5/31/2013,After Earth,130000000,60522097,251499665,121499665,0.934613
11/26/2008,Australia,130000000,49554002,215080810,85080810,0.654468
7/19/2013,R.I.P.D.,130000000,33618855,79076678,-50923322,-0.391718
1/3/2019,How to Train Your Dragon: The Hidden World,129000000,160799505,522747474,393747474,3.05231
11/18/2011,The Twilight Saga: Breaking Dawn Part 1,127500000,281287133,689420051,561920051,4.40722
5/19/2000,Dinosaur,127500000,137748063,356148063,228648063,1.79332
2/23/2017,Logan,127000000,226277068,614202315,487202315,3.83624
12/18/2014,Night at the Museum: Secret of the Tomb,127000000,113746621,353756621,226756621,1.78549
7/13/2011,Harry Potter and the Deathly Hallows: Part II,125000000,381193157,1333857729,1208857729,9.67086
11/19/2014,The Hunger Games: Mockingjay - Part 1,125000000,337135885,766575131,641575131,5.1326
11/15/2001,Harry Potter and the Sorcerer’s Stone,125000000,317871467,965054122,840054122,6.72043
12/4/2019,Jumanji: The Next Level,125000000,316831246,798332900,673332900,5.38666
11/17/2010,Harry Potter and the Deathly Hallows: Part I,125000000,296131568,955371891,830371891,6.64298
5/19/2006,The Da Vinci Code,125000000,217536138,767820459,642820459,5.14256
4/30/2003,X-Men 2,125000000,214949694,406348630,281348630,2.25079
4/21/2011,Fast Five,125000000,210031325,630163454,505163454,4.04131
8/8/2014,Teenage Mutant Ninja Turtles,125000000,191204754,485004754,360004754,2.88004
12/16/2011,Sherlock Holmes: A Game of Shadows,125000000,186848418,535663443,410663443,3.28531
5/27/2004,The Day After Tomorrow,125000000,186740799,555840117,430840117,3.44672
3/17/2017,The Boss Baby,125000000,175003033,527965936,402965936,3.22373
4/1/2010,Clash of the Titans,125000000,163214888,493214888,368214888,2.94572
10/12/2016,Trolls,125000000,153707064,343242613,218242613,1.74594
5/19/1998,Godzilla,125000000,136314294,376000000,251000000,2.008
5/30/2012,Prometheus,125000000,126477084,402448265,277448265,2.21959
8/10/2012,The Bourne Legacy,125000000,113203870,280355920,155355920,1.24285
6/20/1997,Batman & Robin,125000000,107325195,238317814,113317814,0.906543
7/5/2018,Skyscraper,125000000,68420120,304868961,179868961,1.43895
1/3/2020,The Call of the Wild,125000000,62342368,107360936,-17639064,-0.141113
8/3/2012,Total Recall,125000000,58877969,211856088,86856088,0.694849
12/21/2016,Assassin’s Creed,125000000,54647948,240759682,115759682,0.926077
12/29/2016,Monster Trucks,125000000,33370166,61642798,-63357202,-0.506858
8/27/1999,The 13th Warrior,125000000,32698899,61698899,-63301101,-0.506409
11/17/2000,How the Grinch Stole Christmas,123000000,260348825,345445403,222445403,1.8085
5/24/2000,Mission: Impossible 2,120000000,215409889,549588516,429588516,3.5799
6/30/2000,The Perfect Storm,120000000,182618434,328711434,208711434,1.73926
7/20/2016,Jason Bourne,120000000,162192920,416168316,296168316,2.46807
6/15/2007,Fantastic Four: Rise of the Silver Surfer,120000000,131921738,289480691,169480691,1.41234
11/21/2012,Life of Pi,120000000,124987022,619310368,499310368,4.16092
2/16/2007,Ghost Rider,120000000,115802596,229545589,109545589,0.91288
4/9/2018,Rampage,120000000,101028233,427947217,307947217,2.56623
6/27/2003,Charlie's Angels: Full Throttle,120000000,100814328,227163273,107163273,0.893027
8/9/2013,Elysium,120000000,93050117,286192091,166192091,1.38493
4/19/2013,Oblivion,120000000,89107235,287916633,167916633,1.39931
3/24/2017,Power Rangers,120000000,85364450,142531552,22531552,0.187763
7/19/2002,Stuart Little 2,120000000,64956806,166000000,46000000,0.383333
2/12/2014,RoboCop,120000000,58607007,242981799,122981799,1.02485
6/11/2004,The Chronicles of Riddick,120000000,57712751,107212751,-12787249,-0.10656
8/5/2015,The Fantastic Four,120000000,56117548,167849187,47849187,0.398743
5/9/2008,Speed Racer,120000000,43945766,93394462,-26605538,-0.221713
7/22/2005,The Island,120000000,35818913,163018913,43018913,0.358491
12/17/2010,How Do You Know?,120000000,30212620,49628177,-70371823,-0.586432
6/23/2010,Knight and Day,117000000,76423035,258751370,141751370,1.21155
1/25/2021,Tang Ren Jie Tan An 3,117000000,0,699084069,582084069,4.97508
10/2/2018,Venom,116000000,213511408,853530899,737530899,6.35802
5/19/1999,Star Wars Ep. I: The Phantom Menace,115000000,474544677,1027044677,912044677,7.93082
5/19/2005,Star Wars Ep. III: Revenge of the Sith,115000000,380270577,848998877,733998877,6.3826
5/16/2002,Star Wars Ep. II: Attack of the Clones,115000000,310676740,656695615,541695615,4.7104
11/2/2001,Monsters Inc.,115000000,290149425,560483719,445483719,3.87377
7/26/2013,The Wolverine,115000000,132556852,416456852,301456852,2.62136
2/7/1997,Dante’s Peak,115000000,67163857,178200000,63200000,0.549565
4/6/2016,The Huntsman: Winter’s War,115000000,48003015,165149302,50149302,0.436081
6/14/2002,Windtalkers,115000000,40914068,77628265,-37371735,-0.324972
7/4/2008,Astérix aux Jeux Olympiques,113500000,999811,132999811,19499811,0.171805
12/24/2010,Gulliver's Travels,112000000,42779261,232017848,120017848,1.07159
12/8/2017,Ferdinand,111000000,84410380,289838913,178838913,1.61116
5/11/2018,Deadpool 2,110000000,324591735,786362370,676362370,6.14875
10/3/2013,Gravity,110000000,274092705,688214291,578214291,5.25649
12/22/2006,Night at the Museum,110000000,250863268,579446407,469446407,4.26769
9/30/2021,Venom: Let There be Carnage,110000000,211047187,482241132,372241132,3.38401
6/10/2005,Mr. and Mrs. Smith,110000000,186336279,486124090,376124090,3.41931
5/27/2015,San Andreas,110000000,155190832,456258539,346258539,3.1478
7/29/2011,The Smurfs,110000000,142614158,563749323,453749323,4.12499
6/27/2007,Live Free or Die Hard,110000000,134529403,382288147,272288147,2.47535
3/18/2015,The Divergent Series: Insurgent,110000000,130179072,295075882,185075882,1.68251
12/10/2004,Ocean's Twelve,110000000,125531634,362989076,252989076,2.2999
12/19/1997,Tomorrow Never Dies,110000000,125304276,339504276,229504276,2.0864
6/28/2000,The Patriot,110000000,113330342,215300000,105300000,0.957273
3/7/2014,300: Rise of an Empire,110000000,106580051,330780051,220780051,2.00709
12/17/2004,The Aviator,110000000,102608827,208370892,98370892,0.894281
12/21/2016,Passengers,110000000,100014699,302239672,192239672,1.74763
1/14/2011,The Green Hornet,110000000,98780042,229155503,119155503,1.08323
9/21/2016,Miss Peregrine’s Home for Peculiar Children,110000000,87242834,295986876,185986876,1.69079
10/7/2011,Real Steel,110000000,85463309,263880341,153880341,1.39891
6/12/2019,Men in Black: International,110000000,80001807,253020464,143020464,1.30019
6/11/2010,The A-Team,110000000,77222099,177241171,67241171,0.611283
7/31/2013,The Smurfs 2,110000000,71017784,348547523,238547523,2.16861
3/9/2016,The Divergent Series: Allegiant,110000000,66184051,172022517,62022517,0.563841
6/12/2009,The Taking of Pelham 123,110000000,65452312,152364370,42364370,0.385131
10/25/2013,Ender's Game,110000000,61737191,127983283,17983283,0.163484
4/2/2004,Home on the Range,110000000,50026353,76482461,-33517539,-0.304705
6/13/1997,Speed 2: Cruise Control,110000000,48097081,150468000,40468000,0.367891
5/6/2005,Kingdom of Heaven,110000000,47398413,218674938,108674938,0.987954
3/23/2017,Ghost in the Shell,110000000,40563557,167910690,57910690,0.526461
6/16/2004,Around the World in 80 Days,110000000,24004159,72004159,-37995841,-0.345417
11/21/2003,The Cat in the Hat,109000000,101018283,133818283,24818283,0.227691
12/25/2001,Ali,109000000,58183966,87683966,-21316034,-0.19556
9/30/2015,The Martian,108000000,228433663,655111538,547111538,5.06585
11/20/2016,Allied,106000000,40098064,119266661,13266661,0.125157
7/16/2004,I Robot,105000000,144801023,348629585,243629585,2.32028
12/17/1999,Stuart Little,105000000,140015224,298815224,193815224,1.84586
11/25/2009,The Princess and the Frog,105000000,104400899,270997378,165997378,1.58093
3/7/2008,10000 B.C.,105000000,94784201,269065678,164065678,1.56253
7/1/2016,Ice Age: Collision Course,105000000,64063008,402156682,297156682,2.83006
4/27/2001,Town & Country,105000000,6712451,10364769,-94635231,-0.901288
9/19/2017,Kingsman: The Golden Circle,104000000,100234838,408803696,304803696,2.9308
6/9/2000,Gone in 60 Seconds,103300000,101643008,232643008,129343008,1.25211
5/4/2000,Gladiator,103000000,187683805,456435588,353435588,3.43141
5/23/2013,The Hangover 3,103000000,112200072,362000072,259000072,2.51456
3/9/2018,A Wrinkle in Time,103000000,100478608,133214549,30214549,0.293345
7/1/2009,Public Enemies,102500000,97104620,212282709,109782709,1.07105
11/17/2006,Casino Royale,102000000,167365000,594420283,492420283,4.82765
6/21/2002,Minority Report,102000000,132024714,358824714,256824714,2.51789
12/13/2018,Bumblebee,102000000,127195589,465195589,363195589,3.56074
10/26/2012,Cloud Atlas,102000000,27108272,130673154,28673154,0.281109
11/15/2002,Harry Potter and the Chamber of Secrets,100000000,262233381,875262553,775262553,7.75263
7/2/1991,Terminator 2: Judgment Day,100000000,203464105,515390883,415390883,4.15391
6/16/1995,Batman Forever,100000000,184031112,336529144,236529144,2.36529
7/27/2001,Planet of the Apes,100000000,180011740,362211740,262211740,2.62212
11/19/2004,National Treasure,100000000,173005002,331323410,231323410,2.31323
12/25/2012,Django Unchained,100000000,162805434,449841566,349841566,3.49842
12/25/2019,1917,100000000,159227644,370603379,270603379,2.70603
12/22/2010,Little Fockers,100000000,148438600,310650574,210650574,2.10651
7/15/1994,True Lies,100000000,146282411,365300000,265300000,2.653
11/2/2007,American Gangster,100000000,130164645,267985456,167985456,1.67985
9/18/2009,Cloudy with a Chance of Meatballs,100000000,124870275,236827677,136827677,1.36828
8/6/2010,The Other Guys,100000000,119219978,170936470,70936470,0.709365
12/17/2004,Lemony Snicket's A Series of Unfortunate Events,100000000,118627117,212956024,112956024,1.12956
12/25/2013,The Wolf of Wall Street,100000000,116949183,389918903,289918903,2.89919
5/24/2013,Epic,100000000,107518682,262794441,162794441,1.62794
6/21/1996,Eraser,100000000,101295562,234400000,134400000,1.344
6/21/1996,The Hunchback of Notre Dame,100000000,100138851,325500000,225500000,2.255
12/15/2000,The Emperor's New Groove,100000000,89630573,169630573,69630573,0.696306
8/15/2012,The Expendables 2,100000000,85028192,311979256,211979256,2.11979
10/16/2009,Where the Wild Things Are,100000000,77233467,99123656,-876344,-0.00876344
12/15/2006,Eragon,100000000,75030163,249488115,149488115,1.49488
7/23/2014,Hercules,100000000,72688614,243388614,143388614,1.43389
12/10/2010,The Tourist,100000000,67631157,278731369,178731369,1.78731
11/24/1999,End of Days,100000000,66889043,212026975,112026975,1.12027
12/25/2019,Spies in Disguise,100000000,66757013,165138481,65138481,0.651385
6/11/2004,The Stepford Wives,100000000,59475623,96150482,-3849518,-0.0384952
6/8/2007,Surf’s Up,100000000,58867694,145395745,45395745,0.453957
12/8/2006,Blood Diamond,100000000,57377916,171377916,71377916,0.713779
11/7/2019,Midway,100000000,56846802,126829063,26829063,0.268291
9/24/2010,Legend of the Guardians: The Owls of Ga'Hoole,100000000,55675313,139716717,39716717,0.397167
11/7/1997,Starship Troopers,100000000,54768952,121100000,21100000,0.211
6/5/2009,Land of the Lost,100000000,49438370,69548641,-30451359,-0.304514
12/18/2003,Peter Pan,100000000,48417850,95255485,-4744515,-0.0474451
3/15/2019,Wonder Park,100000000,45216793,115112118,15112118,0.151121
7/23/2004,Catwoman,100000000,40202379,82078046,-17921954,-0.17922
8/14/2014,The Expendables 3,100000000,39322544,209461378,109461378,1.09461
11/27/2002,Treasure Planet,100000000,38120554,91800000,-8200000,-0.082
3/12/2010,Green Zone,100000000,35497337,97523020,-2476980,-0.0247698
10/13/2017,Geostorm,100000000,33700160,220796009,120796009,1.20796
12/2/2015,Point Break,100000000,28782481,126704591,26704591,0.267046
12/17/2019,Cats,100000000,27166770,75486351,-24513649,-0.245136
11/26/2015,In the Heart of the Sea,100000000,25020758,89693309,-10306691,-0.103067
4/18/2014,Transcendence,100000000,23022309,103039258,3039258,0.0303926
2/18/2005,Son of the Mask,100000000,17018422,59918422,-40081578,-0.400816
12/5/2018,Mortal Engines,100000000,15951040,85480271,-14519729,-0.145197
2/3/2021,Chaos Walking,100000000,13287908,26943020,-73056980,-0.73057
10/13/2021,The Last Duel,100000000,10853945,29690034,-70309966,-0.7031
8/16/2002,The Adventures of Pluto Nash,100000000,4411102,7094995,-92905005,-0.92905
1/20/2012,Jin líng shí san chai,100000000,311434,98227017,-1772983,-0.0177298
6/12/2020,Artemis Fowl,100000000,0,0,-100000000,-1
12/8/2021,West Side Story,100000000,0,0,-100000000,-1
11/5/2015,The Peanuts Movie,99000000,130178411,250091610,151091610,1.52618
2/6/2019,The LEGO Movie 2: The Second Part,99000000,105806508,190131036,91131036,0.920516
11/21/2018,Robin Hood,99000000,30824628,85210012,-13789988,-0.139293
5/4/2001,The Mummy Returns,98000000,202007640,435040395,337040395,3.43919
11/14/2019,Ford v. Ferrari,97600000,117624357,224418748,126818748,1.29937
12/20/2002,Gangs of New York,97000000,77730500,183124621,86124621,0.887883
5/4/2017,Alien: Covenant,97000000,74262031,238521247,141521247,1.45898
3/6/2015,Cinderella,95000000,201151353,542351353,447351353,4.70896
6/27/2012,Ice Age: Continental Drift,95000000,161321843,879765137,784765137,8.26069
12/28/2001,Black Hawk Down,95000000,108638745,159691085,64691085,0.680959
5/27/2010,Sex and the City 2,95000000,95347692,294680778,199680778,2.1019
2/12/2010,Percy Jackson & the Olympians: The Lightning Thief,95000000,88768303,223050874,128050874,1.3479
8/10/2012,The Campaign,95000000,86907746,104907746,9907746,0.104292
11/12/2010,Unstoppable,95000000,81562942,165720921,70720921,0.744431
5/9/1997,The Fifth Element,95000000,63570862,263893960,168893960,1.77783
3/31/2000,The Road to El Dorado,95000000,50802661,65700000,-29300000,-0.308421
12/11/2009,The Lovely Bones,95000000,44114232,94894448,-105552,-0.00111107
6/30/2016,Ben-Hur,95000000,26410477,91669648,-3330352,-0.0350563
12/19/2014,Seventh Son,95000000,17725785,108874967,13874967,0.146052
5/30/2003,Finding Nemo,94000000,380529370,936094852,842094852,8.95846
12/17/2003,The Lord of the Rings: The Return of the King,94000000,377845905,1120214046,1026214046,10.9172
12/18/2002,The Lord of the Rings: The Two Towers,94000000,342548984,919148764,825148764,8.77818
6/15/2001,Lara Croft: Tomb Raider,94000000,131144183,273330185,179330185,1.90777
1/29/2015,Kingsman: The Secret Service,94000000,128261724,404561724,310561724,3.30385
12/19/2001,The Lord of the Rings: The Fellowship of the Ring,93000000,315544750,891216824,798216824,8.58298
7/18/2001,Jurassic Park III,93000000,181166115,365900000,272900000,2.93441
8/5/2011,Rise of the Planet of the Apes,93000000,176760185,470986200,377986200,4.06437
2/14/2008,The Spiderwick Chronicles,92500000,71195053,162839667,70339667,0.760429
10/22/2004,The Incredibles,92000000,261441092,631441092,539441092,5.86349
2/6/2013,A Good Day to Die Hard,92000000,67349198,304249198,212249198,2.30706
4/9/2004,The Alamo,92000000,22406362,23911362,-68088638,-0.740094
12/22/1995,Cutthroat Island,92000000,10017322,18517322,-73482678,-0.798725
12/19/2013,The Secret Life of Walter Mitty,91000000,58236838,187861183,96861183,1.06441
12/20/2017,Jumanji: Welcome to the Jungle,90000000,404508916,961613199,871613199,9.68459
7/1/1997,Men in Black,90000000,250690539,587790539,497790539,5.53101
11/19/1999,Toy Story 2,90000000,245852179,511358276,421358276,4.68176
8/3/2001,Rush Hour 2,90000000,226164286,347425832,257425832,2.86029
12/25/2009,Sherlock Holmes,90000000,209028679,498438212,408438212,4.5382
1/15/2020,Bad Boys For Life,90000000,204417855,424536881,334536881,3.71708
7/1/2009,Ice Age: Dawn of the Dinosaurs,90000000,196573705,886686817,796686817,8.85208
12/12/2018,Spider-Man: Into The Spider-Verse 3D,90000000,190173195,375654619,285654619,3.17394
7/21/2000,What Lies Beneath,90000000,155464351,288693989,198693989,2.20771
2/13/2020,Sonic The Hedgehog,90000000,146066470,304961681,214961681,2.38846
4/8/2011,Rio,90000000,143619809,487519809,397519809,4.41689
7/24/2019,Once Upon a Time…in Hollywood,90000000,142502728,377562039,287562039,3.19513
10/6/2006,The Departed,90000000,132384315,289660619,199660619,2.21845
11/3/2000,Charlie's Angels,90000000,125305545,259736090,169736090,1.88596
6/19/1998,Mulan,90000000,120620254,303500000,213500000,2.37222
8/13/2008,Tropic Thunder,90000000,110515313,191145256,101145256,1.12384
12/20/2011,The Girl with the Dragon Tattoo,90000000,102515793,239373970,149373970,1.65971
7/11/1997,Contact,90000000,100920329,165900000,75900000,0.843333
6/6/2008,You Don't Mess With the Zohan,90000000,100018837,202910991,112910991,1.25457
5/19/1995,Die Hard: With a Vengeance,90000000,100012499,366101666,276101666,3.0678
9/12/2016,The Magnificent Seven,90000000,93432655,162136124,72136124,0.801512
12/18/2015,Alvin and the Chipmunks: The Road Chip,90000000,85886987,249517956,159517956,1.77242
6/8/2001,Atlantis: The Lost Empire,90000000,84052762,186049020,96049020,1.06721
12/25/2008,Valkyrie,90000000,83107829,203932174,113932174,1.26591
7/16/2015,Pixels,90000000,78765986,244041804,154041804,1.71158
6/29/2001,Artificial Intelligence: AI,90000000,78616689,235900000,145900000,1.62111
11/26/2003,The Haunted Mansion,90000000,75817994,155750628,65750628,0.730563
8/4/2000,Hollow Man,90000000,73209340,191200000,101200000,1.12444
4/22/2005,The Interpreter,90000000,72708161,162753837,72753837,0.808376
8/7/2013,Percy Jackson: Sea of Monsters,90000000,68559554,200859554,110859554,1.23177
7/25/2003,Lara Croft: Tomb Raider: The Cradle of Life,90000000,65653758,157092943,67092943,0.745477
5/27/2016,Now You See Me 2,90000000,65075540,328325007,238325007,2.64806
11/21/2001,Spy Game,90000000,62362560,143049560,53049560,0.58944
4/4/1997,The Saint,90000000,61363304,169400000,79400000,0.882222
3/10/2000,Mission to Mars,90000000,60874615,106000000,16000000,0.177778
3/6/2018,Tomb Raider,90000000,58250803,273477501,183477501,2.03864
12/17/1999,Bicentennial Man,90000000,58220776,87420776,-2579224,-0.028658
7/7/2004,King Arthur,90000000,51877963,203653524,113653524,1.26282
4/25/1997,Volcano,90000000,47546796,120100000,30100000,0.334444
3/26/1997,The Devil's Own,90000000,42885593,140900000,50900000,0.565556
7/19/2002,K-19: The Widowmaker,90000000,35168966,65716126,-24283874,-0.269821
8/19/2011,Conan the Barbarian,90000000,21295021,63356133,-26643867,-0.296043
10/21/2011,The Three Musketeers,90000000,20377913,139877913,49877913,0.554199
4/21/2017,The Promise,90000000,8224288,10551417,-79448583,-0.882762
11/24/2010,The Nutcracker in 3D,90000000,195459,20466016,-69533984,-0.7726
12/13/2017,Bright,90000000,0,0,-90000000,-1
5/14/2021,Army of the Dead,90000000,0,0,-90000000,-1
5/10/1996,Twister,88000000,241688385,495700000,407700000,4.63295
6/3/2005,Cinderella Man,88000000,61649911,105021488,17021488,0.193426
9/11/2018,The Predator,88000000,51024708,159487563,71487563,0.812359
7/21/2021,Snake Eyes: G.I. Joe Origins,88000000,28264325,34666981,-53333019,-0.606057
7/8/2005,Fantastic Four,87500000,154696080,333132750,245632750,2.80723
2/9/2001,Hannibal,87000000,165092266,350100280,263100280,3.02414
7/25/2003,Seabiscuit,86000000,120277854,148715342,62715342,0.729248
12/22/2000,Cast Away,85000000,233632142,427230516,342230516,4.02624
11/17/2006,Happy Feet,85000000,198000317,385000317,300000317,3.52942
12/7/2001,Ocean's Eleven,85000000,183417150,450728529,365728529,4.30269
7/23/2004,The Bourne Supremacy,85000000,176087450,311001124,226001124,2.65884
7/25/1997,Air Force One,85000000,172956409,315268353,230268353,2.70904
4/2/2009,Fast & Furious,85000000,155064265,359347833,274347833,3.22762
3/14/2008,Horton Hears a Who,85000000,154529439,299477886,214477886,2.52327
3/21/2014,Divergent,85000000,150947895,276014965,191014965,2.24723
9/27/2012,Hotel Transylvania,85000000,148313048,378223189,293223189,3.44968
4/3/2019,Shazam!,85000000,140371656,363664533,278664533,3.27841
11/21/2007,Enchanted,85000000,127706877,340384141,255384141,3.00452
2/8/2012,Safe House,85000000,126181630,207884401,122884401,1.4457
7/20/2007,I Now Pronounce You Chuck and Larry,85000000,119725280,185708462,100708462,1.18481
6/8/2007,Ocean's Thirteen,85000000,117144465,311744465,226744465,2.66758
12/25/2009,It’s Complicated,85000000,112735375,224614744,139614744,1.64253
11/20/1998,Enemy of the State,85000000,111549836,250649836,165649836,1.94882
9/29/2006,Open Season,85000000,85105259,191932158,106932158,1.25803
11/4/2011,Tower Heist,85000000,78046570,150422946,65422946,0.769682
11/22/2000,102 Dalmatians,85000000,66941559,66941559,-18058441,-0.212452
3/15/2012,Mirror Mirror,85000000,64935167,173613482,88613482,1.04251
12/8/2006,The Holiday,85000000,63280000,204920447,119920447,1.41083
6/15/2006,The Fast and the Furious: Tokyo Drift,85000000,62615510,157794205,72794205,0.856402
12/9/2005,Memoirs of a Geisha,85000000,57010853,161510853,76510853,0.900128
3/16/2001,Enemy at the Gates,85000000,51396781,96971293,11971293,0.140839
6/18/1993,Last Action Hero,85000000,50016394,137298489,52298489,0.615276
9/26/2003,The Rundown,85000000,47641743,80831893,-4168107,-0.0490366
11/11/2011,Arthur Christmas,85000000,46462469,148227995,63227995,0.743859
1/19/2017,xXx: Return of Xander Cage,85000000,44898413,345033359,260033359,3.05922
11/13/1998,Meet Joe Black,85000000,44650003,44650003,-40349997,-0.474706
7/30/2010,Cats & Dogs: The Revenge of Kitty Galore,85000000,43585753,113026383,28026383,0.329722
2/8/2002,Collateral Damage,85000000,40048332,78353508,-6646492,-0.078194
3/15/2002,Showtime,85000000,37948765,78948765,-6051235,-0.071191
6/30/1995,Judge Dredd,85000000,34687912,113487912,28487912,0.335152
3/2/2007,Zodiac,85000000,33080084,83080084,-1919916,-0.0225872
8/13/2010,Scott Pilgrim vs. The World,85000000,32841100,49286548,-35713452,-0.420158
3/28/2003,The Core,85000000,31111260,74120792,-10879208,-0.127991
5/9/1997,Father's Day,85000000,28681080,35681080,-49318920,-0.580223
12/11/2017,The Greatest Showman,84000000,174340174,433748957,349748957,4.16368
6/14/2002,Scooby-Doo,84000000,153294164,276294164,192294164,2.28922
7/28/2000,Nutty Professor II: The Klumps,84000000,123307945,166307945,82307945,0.979856
7/19/2013,RED 2,84000000,53262560,141507355,57507355,0.684611
6/23/2006,Click,82500000,137355633,237685089,155185089,1.88103
12/15/2006,Charlotte\'s Web,82500000,82985708,143985708,61485708,0.745281
2/14/2008,Jumper,82500000,80172128,222640812,140140812,1.69868
7/11/2008,Hellboy II: The Golden Army,82500000,75986503,160388063,77888063,0.944098
5/27/2005,The Longest Yard,82000000,158119460,191558505,109558505,1.33608
8/13/2010,The Expendables,82000000,103068524,268268174,186268174,2.27156
2/5/2020,Birds of Prey (And the Fantabulous Emancipation…,82000000,84158461,201852140,119852140,1.46161
7/1/2021,The Boss Baby: Family Business,82000000,57300280,132770829,50770829,0.619156
11/17/2000,The 6th Day,82000000,34543701,96024898,14024898,0.171035
5/23/2003,Bruce Almighty,81000000,242704995,484468608,403468608,4.98109
3/8/2012,The Hunger Games,80000000,408010692,677923379,597923379,7.47404
5/26/2011,The Hangover Part II,80000000,254464305,586764305,506764305,6.33455
5/21/1996,Mission: Impossible,80000000,180981886,457697994,377697994,4.72122
2/2/2017,The Lego Batman Movie,80000000,175750384,310570560,230570560,2.88213
9/23/2015,Hotel Transylvania 2,80000000,169700110,469831205,389831205,4.87289
6/18/1992,Batman Returns,80000000,162833635,266824291,186824291,2.3353
5/24/2019,The Secret Life of Pets 2,80000000,158874395,446275938,366275938,4.57845
5/7/1999,The Mummy,80000000,155385488,416385488,336385488,4.20482
5/19/2006,Over the Hedge,80000000,155019340,343397247,263397247,3.29247
6/21/2002,Lilo & Stitch,80000000,145771527,245800000,165800000,2.0725
5/8/1998,Deep Impact,80000000,140464664,349464664,269464664,3.36831
7/12/2013,Grown Ups 2,80000000,133668525,247023808,167023808,2.0878
12/14/2011,Alvin and the Chipmunks: Chipwrecked,80000000,133107389,349088523,269088523,3.36361
6/20/2008,Get Smart,80000000,130319208,226739416,146739416,1.83424
3/11/2005,Robots,80000000,128200012,260636271,180636271,2.25795
2/19/2010,Shutter Island,80000000,128012934,299461782,219461782,2.74327
12/12/2003,Something's Gotta Give,80000000,124685242,266685242,186685242,2.33357
11/26/2008,Four Christmases,80000000,120146040,168311558,88311558,1.10389
6/27/1997,Face/Off,80000000,112276146,241200000,161200000,2.015
12/25/2008,Bedtime Stories,80000000,110101975,221468935,141468935,1.76836
7/12/2002,Road to Perdition,80000000,104054514,183354514,103354514,1.29193
2/11/2011,Just Go With It,80000000,103028109,214974953,134974953,1.68719
2/14/2003,Daredevil,80000000,102543518,182782518,102782518,1.28478
9/26/2008,Eagle Eye,80000000,101440743,180585259,100585259,1.25732
6/6/1997,Con Air,80000000,101117573,224117573,144117573,1.80147
12/17/2010,Yogi Bear,80000000,100246011,204774690,124774690,1.55968
12/25/2003,Cold Mountain,80000000,95632614,165173909,85173909,1.06467
1/15/2010,The Book of Eli,80000000,94835059,158750817,78750817,0.984385
11/26/1997,Flubber,80000000,92993801,177993801,97993801,1.22492
7/23/1999,The Haunting,80000000,91188905,180188905,100188905,1.25236
11/15/1996,Space Jam,80000000,90463534,250180384,170180384,2.12725
10/17/2014,Fury,80000000,85817906,210315681,130315681,1.62895
9/21/2018,Smallfoot,80000000,83240103,213682073,133682073,1.67103
2/10/2006,The Pink Panther,80000000,82226474,158926474,78926474,0.986581
7/8/2011,Zookeeper,80000000,80360866,170805525,90805525,1.13507
12/12/2008,The Day the Earth Stood Still,80000000,79366978,237370350,157370350,1.96713
8/8/1997,Conspiracy Theory,80000000,76118990,142783718,62783718,0.784796
6/12/1998,Six Days Seven Nights,80000000,74339294,164800000,84800000,1.06
5/24/2002,Spirit: Stallion of the Cimarron,80000000,73215310,106515310,26515310,0.331441
6/8/2001,Swordfish,80000000,69772969,147080413,67080413,0.838505
12/31/1999,Fantasia 2000 (Theatrical Release),80000000,69610858,69618634,-10381366,-0.129767
4/3/1998,Lost In Space,80000000,69117629,136047317,56047317,0.700591
7/30/2004,The Manchurian Candidate,80000000,65948711,96135872,16135872,0.201698
11/22/2006,Déjà Vu,80000000,64038616,181038616,101038616,1.26298
6/24/2005,Bewitched,80000000,63313159,131159306,51159306,0.639491
12/22/2006,The Good Shepherd,80000000,59908565,100378271,20378271,0.254728
3/8/2002,The Time Machine,80000000,56684819,98983590,18983590,0.237295
10/2/1998,What Dreams May Come,80000000,55485043,71485043,-8514957,-0.106437
12/25/1998,Mighty Joe Young,80000000,50632037,50632037,-29367963,-0.3671
9/19/2019,Ad Astra,80000000,50188370,135432019,55432019,0.6929
10/28/2005,The Legend of Zorro,80000000,45575336,141475336,61475336,0.768442
11/10/2000,Little Nicky,80000000,39442871,58270391,-21729609,-0.27162
9/25/2009,Surrogates,80000000,38577772,119668350,39668350,0.495854
6/8/2001,Evolution,80000000,38311134,98341932,18341932,0.229274
8/26/2005,The Brothers Grimm,80000000,37899638,105299638,25299638,0.316245
12/13/1996,Mars Attacks!,80000000,37771017,101371017,21371017,0.267138
4/14/2006,The Wild,80000000,37384046,99010667,19010667,0.237633
12/20/2013,Walking with Dinosaurs,80000000,36076121,123368842,43368842,0.542111
12/22/2000,Thirteen Days,80000000,34566746,66554547,-13445453,-0.168068
12/6/1996,Daylight,80000000,32908290,158908290,78908290,0.986354
10/21/2015,The Last Witch Hunter,80000000,27367660,130818912,50818912,0.635236
2/21/2014,Pompeii,80000000,23169033,108469033,28469033,0.355863
5/12/2000,Battlefield Earth: A Saga of the Year 3000,80000000,21471685,29725663,-50274337,-0.628429
11/14/2003,Looney Tunes: Back in Action,80000000,20950820,54540662,-25459338,-0.318242
12/18/2009,Nine,80000000,19676965,56984219,-23015781,-0.287697
11/26/2003,Timeline,80000000,19480739,26703184,-53296816,-0.66621
4/22/2010,Oceans,80000000,19422319,86787530,6787530,0.0848441
11/25/1998,Babe: Pig in the City,80000000,18319860,69131860,-10868140,-0.135852
12/25/1997,The Postman,80000000,17650704,20841123,-59158877,-0.739486
11/10/2000,Red Planet,80000000,17480890,33463969,-46536031,-0.5817
1/12/2007,Arthur et les Minimoys,80000000,15132763,113325743,33325743,0.416572
8/17/2007,The Invasion,80000000,15074191,40147042,-39852958,-0.498162
9/2/2005,A Sound of Thunder,80000000,1900451,6300451,-73699549,-0.921244
11/1/2019,The Aeronauts,80000000,0,6628720,-73371280,-0.917141
6/15/1994,The Lion King,79300000,421785283,986214868,906914868,11.4365
2/2/2012,Journey 2: The Mysterious Island,79000000,103860290,318146162,239146162,3.02717
11/11/2011,Jack and Jill,79000000,74158157,150519217,71519217,0.905307
12/21/2001,A Beautiful Mind,78000000,170708996,317668058,239668058,3.07267
9/26/2013,Cloudy with a Chance of Meatballs 2,78000000,119793567,274392649,196392649,2.51785
10/4/2002,Red Dragon,78000000,92955420,206455420,128455420,1.64686
3/5/2004,Hidalgo,78000000,67286731,108086731,30086731,0.385727
7/11/2003,The League of Extraordinary Gentlemen,78000000,66465204,179265204,101265204,1.29827
8/20/2004,Exorcist: The Beginning,78000000,41814863,43957541,-34042459,-0.436442
10/17/2012,Astérix et Obélix: Au service de Sa Majesté,77600000,0,60680125,-16919875,-0.21804
7/29/2015,The Little Prince,77500000,1311213,102028919,24528919,0.316502
9/1/2017,Renegades,77500000,0,1521672,-75978328,-0.980366
7/18/2018,The Equalizer 2,77000000,102084362,190376181,113376181,1.47242
6/26/2013,Despicable Me 2,76000000,368065385,975216835,899216835,11.8318
6/6/2003,2 Fast 2 Furious,76000000,127120058,236410607,160410607,2.11067
12/25/2006,Children of Men,76000000,35552383,69845011,-6154989,-0.0809867
6/30/2000,The Adventures of Rocky & Bullwinkle,76000000,26000610,35129610,-40870390,-0.537768
5/8/2016,The Secret Life of Pets,75000000,368384330,885302500,810302500,10.804
7/2/1996,Independence Day,75000000,306169255,817400878,742400878,9.89868
11/7/2018,Dr. Seuss’ The Grinch,75000000,270834950,514602427,439602427,5.86137
11/24/2016,Sing,75000000,270329045,632483611,557483611,7.43311
6/14/2017,Despicable Me 3,75000000,264624300,1032596894,957596894,12.768
5/22/1997,The Lost World: Jurassic Park,75000000,229086679,618638999,543638999,7.24852
3/31/2006,Ice Age: The Meltdown,75000000,195330621,651899282,576899282,7.69199
5/27/2005,Madagascar,75000000,193595521,556559566,481559566,6.42079
6/25/2010,Grown Ups,75000000,162001186,272223000,197223000,2.62964
9/20/2004,Shark Tale,75000000,161412000,371741123,296741123,3.95655
7/14/2000,X-Men,75000000,157299717,296872367,221872367,2.9583
6/27/2008,Wanted,75000000,134508551,342416460,267416460,3.56555
6/7/1996,The Rock,75000000,134069511,336069511,261069511,3.48093
2/13/2004,50 First Dates,75000000,120776832,196320329,121320329,1.6176
7/18/2018,Mamma Mia: Here We Go Again!,75000000,120634935,399228127,324228127,4.32304
7/20/2007,Hairspray,75000000,118871849,202822861,127822861,1.7043
5/31/2013,Now You See Me,75000000,117723989,342769200,267769200,3.57026
11/18/2021,Ghostbusters: Afterlife,75000000,103673364,146405652,71405652,0.952075
12/15/2006,Dreamgirls,75000000,103365956,155620350,80620350,1.07494
8/3/2018,Christopher Robin,75000000,99215042,197744377,122744377,1.63659
7/23/1999,Inspector Gadget,75000000,97387965,97387965,22387965,0.298506
11/11/2011,Immortals,75000000,83504017,211562435,136562435,1.82083
6/18/2004,The Terminal,75000000,77073959,218673959,143673959,1.91565
2/18/2005,Constantine,75000000,75976178,221593554,146593554,1.95458
7/21/2006,Monster House,75000000,73661010,141267370,66267370,0.883565
12/8/2000,Vertical Limit,75000000,68473360,213500000,138500000,1.84667
12/21/2007,Charlie Wilson’s War,75000000,66661095,119512771,44512771,0.593504
4/16/1999,Life,75000000,64062587,73521587,-1478413,-0.0197122
9/19/2019,Abominable,75000000,60761390,188659191,113659191,1.51546
3/4/2005,Be Cool,75000000,55849401,94944017,19944017,0.26592
12/23/2005,Munich,75000000,47379090,131492772,56492772,0.753237
6/4/2010,Killers,75000000,47059963,95572749,20572749,0.274303
8/12/2015,The Man From U.N.C.L.E.,75000000,45445109,108517735,33517735,0.446903
3/7/2003,Tears of the Sun,75000000,43632458,85632458,10632458,0.141766
7/21/2006,Lady in the Water,75000000,42285169,72785169,-2214831,-0.0295311
12/17/2004,Spanglish,75000000,42044321,54344321,-20655679,-0.275409
10/12/2001,Bandits,75000000,41523271,71523271,-3476729,-0.0463564
12/17/1999,Anna and the King,75000000,39251128,39251128,-35748872,-0.476652
7/7/1995,First Knight,75000000,37361412,127361412,52361412,0.698152
3/25/2011,Sucker Punch,75000000,36392502,89758389,14758389,0.196779
3/11/2005,Hostage,75000000,34636443,77636443,2636443,0.0351526
10/5/2016,Inferno,75000000,34343574,219519367,144519367,1.92692
6/13/2003,Hollywood Homicide,75000000,30207785,50409753,-24590247,-0.32787
6/16/2000,Titan A.E.,75000000,22751979,36751979,-38248021,-0.509974
12/17/2004,Flight of the Phoenix,75000000,21009180,34009180,-40990820,-0.546544
10/23/1998,Soldier,75000000,14623082,14623082,-60376918,-0.805026
1/15/1999,Virus,75000000,14010690,30626690,-44373310,-0.591644
2/23/2001,Monkeybone,75000000,5409517,5409517,-69590483,-0.927873
8/7/2019,PLAYMOBIL,75000000,1115008,16288031,-58711969,-0.782826
1/6/2022,The 355,75000000,0,0,-75000000,-1
6/17/2015,Minions,74000000,336045770,1159631140,1085631140,14.6707
1/28/2015,The SpongeBob Movie: Sponge Out of Water,74000000,162994032,311013181,237013181,3.20288
11/22/2000,Unbreakable,73243106,94999143,248099143,174856037,2.38734
8/4/2006,Talladega Nights: The Ballad of Ricky Bobby,73000000,148213377,162870525,89870525,1.2311
5/11/2016,The Angry Birds Movie,73000000,107509366,352327887,279327887,3.82641
8/7/1998,Snake Eyes,73000000,55591409,103891409,30891409,0.42317
2/13/1998,Sphere,73000000,37068294,50168294,-22831706,-0.312763
7/26/2007,The Simpsons Movie,72500000,183135014,527071022,454571022,6.26995
2/8/2008,Fool’s Gold,72500000,70231041,109362966,36862966,0.508455
7/31/2009,Funny People,72500000,51855045,71880305,-619695,-0.00854752
9/28/2007,The Kingdom,72500000,47467250,86802457,14302457,0.197275
6/22/2001,Dr. Dolittle 2,72000000,112950721,176101721,104101721,1.44586
5/24/1995,Braveheart,72000000,75545647,209045244,137045244,1.90341
11/4/2005,Jarhead,72000000,62647540,96947540,24947540,0.346494
4/27/2001,Driven,72000000,32616869,54616869,-17383131,-0.241432
12/21/2001,The Majestic,72000000,27796042,37306334,-34693666,-0.481856
6/25/2004,Two Brothers,72000000,19176754,62176754,-9823246,-0.136434
7/30/2004,The Village,71682975,114197520,257641634,185958659,2.59418
6/26/1998,Doctor Dolittle,71500000,144156605,294156605,222656605,3.11408
8/2/2002,Signs,70702619,227969295,408250578,337547959,4.77419
5/19/2004,Shrek 2,70000000,441226247,935253978,865253978,12.3608
5/1/2006,Cars,70000000,244082982,461630558,391630558,5.59472
12/23/2009,Alvin and the Chipmunks: The Squeakquel,70000000,219614612,443483213,373483213,5.33547
9/4/2019,It: Chapter Two,70000000,211593228,469566806,399566806,5.7081
6/22/1988,Who Framed Roger Rabbit?,70000000,154112492,351500000,281500000,4.02143
7/30/1999,Runaway Bride,70000000,152257509,310138178,240138178,3.43055
8/9/2002,xXx,70000000,141930000,267200000,197200000,2.81714
6/8/2018,Ocean’s 8,70000000,140218711,297718711,227718711,3.25312
11/8/1996,Ransom,70000000,136492681,308700000,238700000,3.41
8/21/2009,Inglourious Basterds,70000000,120774594,316915264,246915264,3.52736
12/11/1991,Hook,70000000,119654823,300854823,230854823,3.29793
7/3/1990,Die Hard 2,70000000,117323878,239813888,169813888,2.42591
8/8/2003,S.W.A.T.,70000000,116877597,207154748,137154748,1.95935
11/10/2017,Daddy’s Home 2,70000000,104029443,175807183,105807183,1.51153
11/19/1999,Sleepy Hollow,70000000,101068340,207068340,137068340,1.95812
12/14/2001,Vanilla Sky,70000000,100614858,202726605,132726605,1.89609
6/13/1997,Hercules,70000000,99112101,250700000,180700000,2.58143
3/20/2013,Olympus Has Fallen,70000000,98927592,172878928,102878928,1.4697
3/11/2011,Battle: Los Angeles,70000000,83552429,213463976,143463976,2.04949
8/13/2004,AVP: Alien Vs. Predator,70000000,80281096,172543519,102543519,1.46491
12/25/2011,War Horse,70000000,79883359,156815529,86815529,1.24022
3/1/2002,We Were Soldiers,70000000,78120196,114658262,44658262,0.637975
2/7/2014,The Monuments Men,70000000,78031620,158702748,88702748,1.26718
9/22/2016,Storks,70000000,72679278,183353431,113353431,1.61933
12/11/1998,Star Trek: Insurrection,70000000,70187658,117800000,47800000,0.682857
12/10/2003,Big Fish,70000000,66432867,123954323,53954323,0.770776
6/17/1994,Wolf,70000000,65011757,131011757,61011757,0.871597
1/20/2012,Underworld: Awakening,70000000,62321039,160379930,90379930,1.29114
9/15/2017,The Lego Ninjago Movie,70000000,59281555,122737201,52737201,0.753389
10/1/2014,Dracula Untold,70000000,55991880,220241723,150241723,2.14631
9/29/2006,The Guardian,70000000,55011732,94973540,24973540,0.356765
8/9/1989,The Abyss,70000000,54243125,54243441,-15756559,-0.225094
9/24/2010,Wall Street 2: Money Never Sleeps,70000000,52474616,137431619,67431619,0.963309
1/14/2011,The Dilemma,70000000,48475290,70546865,546865,0.00781236
12/25/2005,Rumor Has It,70000000,42996140,88933562,18933562,0.270479
11/6/1998,The Siege,70000000,40934175,116625798,46625798,0.666083
8/10/2007,Stardust,70000000,38634938,137022245,67022245,0.957461
6/13/2012,Rock of Ages,70000000,38518613,61031932,-8968068,-0.128115
6/11/2021,The Hitman’s Wife’s Bodyguard,70000000,38014727,67394555,-2605445,-0.0372206
10/8/1997,Seven Years in Tibet,70000000,37945884,131445884,61445884,0.877798
9/17/2004,Sky Captain and the World of Tomorrow,70000000,37760080,49730854,-20269146,-0.289559
9/14/2007,The Brave One,70000000,36793804,69792704,-207296,-0.00296137
11/1/2002,I Spy,70000000,33561137,60279822,-9720178,-0.13886
6/7/2002,Bad Company,70000000,30157016,69157016,-842984,-0.0120426
10/21/2005,Doom,70000000,28212337,58757178,-11242822,-0.160612
1/27/2016,The Finest Hours,70000000,27569558,49252761,-20747239,-0.296389
10/10/2013,Escape Plan,70000000,25135965,103735965,33735965,0.481942
9/23/2011,Killer Elite,70000000,25124986,65409046,-4590954,-0.0655851
1/16/1998,Hard Rain,70000000,19870567,19870567,-50129433,-0.716135
2/15/2002,Hart's War,70000000,19076815,33076815,-36923185,-0.527474
2/8/2002,Rollerball,70000000,18990542,25852508,-44147492,-0.630678
1/10/2014,The Legend of Hercules,70000000,18848538,58953319,-11046681,-0.15781
4/27/2007,Next,70000000,18211013,73591500,3591500,0.0513071
9/20/2002,Ballistic: Ecks vs. Sever,70000000,14294842,14294842,-55705158,-0.795788
8/10/2001,Osmosis Jones,70000000,13596911,13596911,-56403089,-0.805758
5/9/2014,Legends of Oz: Dorothy’s Return,70000000,8462347,20107933,-49892067,-0.712744
1/16/2015,Blackhat,70000000,8005980,19665004,-50334996,-0.719071
3/31/2006,Basic Instinct 2,70000000,5946136,35417162,-34582838,-0.494041
5/28/2010,Agora,70000000,619423,38992292,-31007708,-0.442967
,b,70000000,0,0,-70000000,-1
7/9/2010,Despicable Me,69000000,251513985,543464573,474464573,6.8763
7/30/2010,Dinner for Schmucks,69000000,73026337,86796502,17796502,0.25792
2/28/2018,Red Sparrow,69000000,46874505,145951861,76951861,1.11524
6/30/2010,The Twilight Saga: Eclipse,68000000,300531751,706102828,638102828,9.38387
5/31/2002,The Sum of All Fears,68000000,118471320,193500000,125500000,1.84559
6/25/2015,Ted 2,68000000,81476385,217214143,149214143,2.19433
7/13/2001,The Score,68000000,71069884,113542091,45542091,0.669737
2/25/2011,Hall Pass,68000000,45060734,87173475,19173475,0.281963
11/22/1995,Money Train,68000000,35324232,77224232,9224232,0.13565
3/21/2003,Dreamcatcher,68000000,33685268,75685268,7685268,0.113019
8/6/1999,Mystery Men,68000000,29762011,33462011,-34537989,-0.507912
11/5/1999,The Insider,68000000,28965197,60265197,-7734803,-0.113747
12/22/2017,Downsizing,68000000,24449754,54462971,-13537029,-0.199074
8/18/2021,Reminiscence,67972729,3900193,15451008,-52521721,-0.772688
3/1/2012,Dr. Seuss’ The Lorax,67500000,214030500,350976753,283476753,4.19966
10/10/2008,Body of Lies,67500000,39394666,118556530,51056530,0.756393
6/20/2012,Abraham Lincoln: Vampire Hunter,67500000,37519139,137489730,69989730,1.03688
8/26/2020,The New Mutants,67000000,23855569,44612280,-22387720,-0.334145
9/20/1996,Last Man Standing,67000000,18115927,18149997,-48850003,-0.729105
8/17/2007,The Last Legion,67000000,5932060,25357771,-41642229,-0.621526
4/30/1999,Entrapment,66000000,87707396,211700000,145700000,2.20758
6/19/1998,The X Files: Fight the Future,66000000,83898313,189176423,123176423,1.86631
3/13/2014,Need for Speed,66000000,43568507,194169619,128169619,1.94196
7/24/1998,Saving Private Ryan,65000000,216335085,485035085,420035085,6.46208
12/15/2000,What Women Want,65000000,182805123,374105123,309105123,4.75546
11/9/2012,Lincoln,65000000,182207973,273346281,208346281,3.20533
3/15/2002,Ice Age,65000000,176387405,386116343,321116343,4.94025
6/30/1995,Apollo 13,65000000,173772767,335802271,270802271,4.16619
3/31/1999,The Matrix,65000000,173396389,465377200,400377200,6.15965
6/22/2018,Hotel Transylvania 3: Summer Vacation,65000000,167500092,527848903,462848903,7.12075
12/19/2012,Les Misérables,65000000,148809770,438420442,373420442,5.74493
11/1/2002,The Santa Clause 2,65000000,139225854,172825854,107825854,1.65886
6/1/1990,Total Recall,65000000,119394839,261399830,196399830,3.02154
12/18/1998,You’ve Got Mail,65000000,115821495,250800000,185800000,2.85846
12/25/2014,Unbroken,65000000,115637895,163527824,98527824,1.51581
5/21/2015,Spy!,65000000,110825712,232585748,167585748,2.57824
11/5/2010,Due Date,65000000,100539043,211739043,146739043,2.25752
7/25/2008,Step Brothers,65000000,100468793,128107642,63107642,0.970887
12/15/1995,Jumanji,65000000,100458310,262758310,197758310,3.04244
7/17/1998,The Mask of Zorro,65000000,93828745,233700000,168700000,2.59538
8/4/2000,Space Cowboys,65000000,90454043,128874043,63874043,0.982678
12/18/2014,Annie,65000000,85911262,139829625,74829625,1.15122
5/28/1993,Cliffhanger,65000000,84049211,255000000,190000000,2.92308
8/10/2016,Pete’s Dragon,65000000,76233151,137768975,72768975,1.11952
2/9/1996,Broken Arrow,65000000,70645997,148345997,83345997,1.28225
8/9/2006,World Trade Center,65000000,70278893,163295654,98295654,1.51224
7/7/2000,The Kid,65000000,69688384,69688384,4688384,0.072129
12/19/2003,Mona Lisa Smile,65000000,63803100,141205169,76205169,1.17239
5/16/2012,The Dictator,65000000,59650222,180148897,115148897,1.77152
11/25/2020,The Croods: A New Age,65000000,58568815,214952707,149952707,2.30696
7/16/1999,Eyes Wide Shut,65000000,55691208,104264617,39264617,0.604071
2/16/2012,This Means War,65000000,54760791,156974557,91974557,1.41499
2/26/2015,Focus,65000000,53862963,168065700,103065700,1.58563
12/8/2004,Blade: Trinity,65000000,52397389,131353165,66353165,1.02082
11/21/2012,Red Dawn,65000000,44806783,48164150,-16835850,-0.259013
12/22/2006,We Are Marshall,65000000,43545364,43545364,-21454636,-0.330071
8/17/2015,Everest,65000000,43482270,221297061,156297061,2.40457
9/12/2012,Resident Evil: Retribution,65000000,42345531,240647629,175647629,2.70227
8/2/2019,The Angry Birds Movie 2,65000000,41657076,152018812,87018812,1.33875
3/20/1998,Primary Colors,65000000,39017984,39017984,-25982016,-0.399723
10/15/1999,Fight Club,65000000,37030102,100820947,35820947,0.551091
8/22/2008,Death Race,65000000,36316032,72516819,7516819,0.115643
10/11/1996,The Long Kiss Goodnight,65000000,33447612,33447612,-31552388,-0.485421
12/8/2000,Proof of Life,65000000,32598931,62761005,-2238995,-0.0344461
11/11/2005,Zathura,65000000,28045540,58545540,-6454460,-0.0992994
11/26/2003,The Missing,65000000,26900336,38253433,-26746567,-0.411486
1/14/2005,Elektra,65000000,24409722,56824633,-8175367,-0.125775
10/23/2009,Astro Boy,65000000,19551067,41636243,-23363757,-0.359442
1/24/2014,I Frankenstein,65000000,19075290,74575290,9575290,0.147312
11/29/2019,Underwater,65000000,17291078,39194264,-25805736,-0.397011
5/24/1991,Hudson Hawk,65000000,17218916,17218916,-47781084,-0.735094
8/22/2014,Sin City: A Dame to Kill For,65000000,13757804,40650842,-24349158,-0.374602
12/25/2016,Live by Night,65000000,10378555,21774432,-43225568,-0.665009
10/27/2000,Lucky Numbers,65000000,10014234,10014234,-54985766,-0.845935
9/23/2005,Oliver Twist,65000000,2070920,26670920,-38329080,-0.589678
2/18/2015,Tian jiang xiong shi,65000000,74070,122519874,57519874,0.884921
10/26/2018,Air Strike,65000000,0,516279,-64483721,-0.992057
4/24/2020,Extraction,65000000,0,0,-65000000,-1
7/14/2006,Little Man,64000000,58636047,101636047,37636047,0.588063
10/8/1999,Random Hearts,64000000,31054924,63200000,-800000,-0.0125
12/27/2006,Perfume: The Story of a Murderer,63700000,2223293,133603463,69903463,1.09739
6/11/1993,Jurassic Park,63000000,402523348,1045573035,982573035,15.5964
7/25/2002,Austin Powers in Goldmember,63000000,213117789,296338663,233338663,3.70379
4/1/2011,Hop,63000000,108085305,188494082,125494082,1.99197
9/14/2017,American Assassin,63000000,36249674,68310140,5310140,0.0842879
6/24/1994,Wyatt Earp,63000000,25052000,25052000,-37948000,-0.602349
8/3/1994,Clear and Present Danger,62000000,122012656,207500000,145500000,2.34677
4/21/2000,U-571,62000000,77086030,127630030,65630030,1.05855
11/17/1995,The American President,62000000,60022813,107822813,45822813,0.739078
12/25/2015,The Hateful Eight,62000000,54117416,152366784,90366784,1.45753
6/20/2008,The Love Guru,62000000,32235793,40159017,-21840983,-0.352274
2/23/2001,3000 Miles to Graceland,62000000,15738632,18708848,-43291152,-0.698244
10/3/2014,Gone Girl,61000000,167767189,367160781,306160781,5.01903
5/26/2021,A Quiet Place: Part II,61000000,160215261,296667086,235667086,3.86339
3/30/2007,Blades of Glory,61000000,118594548,145594548,84594548,1.3868
9/9/2015,Maze Runner: The Scorch Trials,61000000,81697192,310566162,249566162,4.09125
8/2/2013,2 Guns,61000000,75612460,132493015,71493015,1.17202
1/17/2018,Maze Runner: The Death Cure,61000000,58032443,265878536,204878536,3.35866
1/9/2019,A Dog’s Way Home,61000000,41952715,81152505,20152505,0.330369
2/7/2016,Mei Ren Yu,60720000,3229457,525018479,464298479,7.64655
12/22/2004,Meet the Fockers,60000000,279167575,516567575,456567575,7.60946
2/6/2014,The Lego Movie,60000000,257784718,468084718,408084718,6.80141
3/9/2007,300,60000000,210614939,454161935,394161935,6.56937
3/2/2007,Wild Hogs,60000000,168213584,253555383,193555383,3.22592
12/25/2008,Marley & Me,60000000,143153751,247812011,187812011,3.1302
12/10/1999,The Green Mile,60000000,136801374,290701374,230701374,3.84502
6/5/1998,The Truman Show,60000000,125618201,264118201,204118201,3.40197
9/8/2016,Sully,60000000,125070033,238524556,178524556,2.97541
6/14/2002,The Bourne Identity,60000000,121468960,214357371,154357371,2.57262
10/8/2009,Couples Retreat,60000000,109205660,172450423,112450423,1.87417
11/17/1995,Goldeneye,60000000,106429941,356429941,296429941,4.9405
5/30/2003,The Italian Job,60000000,106126012,176262839,116262839,1.93771
5/9/2003,Daddy Day Care,60000000,104148781,164285587,104285587,1.73809
6/18/1999,The General\'s Daughter,60000000,102705852,149705852,89705852,1.4951
12/18/1998,The Prince of Egypt,60000000,101413188,218613188,158613188,2.64355
8/6/2004,Collateral,60000000,100170152,217602967,157602967,2.62672
7/4/2001,Cats & Dogs,60000000,93375151,200700000,140700000,2.345
12/20/2002,Two Weeks Notice,60000000,93354918,199043309,139043309,2.31739
10/2/1998,Antz,60000000,90757863,152457863,92457863,1.54096
4/18/2002,The Scorpion King,60000000,90580000,165890634,105890634,1.76484
10/15/2010,Red,60000000,90380162,196439693,136439693,2.27399
3/5/2004,Starsky & Hutch,60000000,88200225,170200225,110200225,1.83667
6/27/1990,Days of Thunder,60000000,82670733,157670733,97670733,1.62785
12/21/2005,Cheaper by the Dozen 2,60000000,82571173,135015330,75015330,1.25026
8/13/2010,Eat Pray Love,60000000,80574010,206598789,146598789,2.44331
12/20/2012,Jack Reacher,60000000,80070736,217370736,157370736,2.62285
4/23/2004,Man on Fire,60000000,77906816,130968579,70968579,1.18281
12/22/2000,The Family Man,60000000,75764085,124715863,64715863,1.0786
9/9/2011,Contagion,60000000,75658097,137551594,77551594,1.29253
12/22/1999,Any Given Sunday,60000000,75530832,100230832,40230832,0.670514
5/15/1998,The Horse Whisperer,60000000,75383563,186883563,126883563,2.11473
2/6/2009,Coraline,60000000,75286229,126037057,66037057,1.10062
10/1/2004,Ladder 49,60000000,74541707,102332848,42332848,0.705547
7/28/1999,Deep Blue Sea,60000000,73648228,165048228,105048228,1.7508
10/28/2009,Michael Jackson's This Is It,60000000,72091016,252091016,192091016,3.20152
1/17/2003,Kangaroo Jack,60000000,66723216,90558582,30558582,0.50931
6/13/2008,The Happening,60000000,64506874,162778384,102778384,1.71297
3/2/2016,London Has Fallen,60000000,62524260,195194085,135194085,2.25323
4/7/2000,Rules of Engagement,60000000,61322858,71719931,11719931,0.195332
3/10/2006,The Shaggy Dog,60000000,61123569,87123569,27123569,0.452059
11/22/1996,Jingle All the Way,60000000,60592389,129832389,69832389,1.16387
4/2/2004,Hellboy,60000000,59623958,99823958,39823958,0.663733
10/20/2016,Jack Reacher: Never Go Back,60000000,58697076,159946489,99946489,1.66577
5/25/2017,Baywatch,60000000,58060186,175863783,115863783,1.93106
3/6/1998,U.S. Marshals,60000000,57833603,57833603,-2166397,-0.0361066
12/25/1998,A Civil Action,60000000,56709981,56709981,-3290019,-0.0548336
12/24/2015,Joy,60000000,56451232,101134059,41134059,0.685568
8/3/2012,ParaNorman,60000000,56003051,108119662,48119662,0.801994
11/14/1997,The Jackal,60000000,54956941,159356941,99356941,1.65595
12/25/2003,Paycheck,60000000,53789313,98819789,38819789,0.646996
3/1/1996,Up Close & Personal,60000000,51045801,100645801,40645801,0.67743
12/19/2008,The Tale of Despereaux,60000000,50877145,90482317,30482317,0.508039
9/19/2014,The Boxtrolls,60000000,50837305,111898741,51898741,0.864979
8/2/2017,The Dark Tower,60000000,50701325,113461527,53461527,0.891025
9/27/2002,The Tuxedo,60000000,50586000,104429625,44429625,0.740494
1/17/2014,Jack Ryan: Shadow Recruit,60000000,50577412,131377412,71377412,1.18962
7/14/1995,Under Siege 2: Dark Territory,60000000,50024083,104324083,44324083,0.738735
3/24/2005,Miss Congeniality 2: Armed and Fabulous,60000000,48478006,101292343,41292343,0.688206
12/21/2018,Vice,60000000,47836282,70893782,10893782,0.181563
11/26/1997,Alien: Resurrection,60000000,47795018,160700000,100700000,1.67833
3/23/2007,Shooter,60000000,47003582,95538560,35538560,0.592309
10/16/1998,Practical Magic,60000000,46850558,68336997,8336997,0.13895
1/9/2013,Gangster Squad,60000000,46000903,104100903,44100903,0.735015
3/24/2017,Smurfs: The Lost Village,60000000,45020282,197578586,137578586,2.29298
10/10/2018,First Man,60000000,44936545,105703325,45703325,0.761722
6/19/2009,Year One,60000000,43337279,57604723,-2395277,-0.0399213
1/29/2010,Edge of Darkness,60000000,43313890,82812456,22812456,0.380208
12/13/2002,Star Trek: Nemesis,60000000,43254409,67312826,7312826,0.12188
2/19/2002,Reign of Fire,60000000,43061982,82150183,22150183,0.36917
11/20/2009,Planet 51,60000000,42194060,108996113,48996113,0.816602
3/20/2009,Duplicity,60000000,40572825,81079566,21079566,0.351326
9/12/2008,Righteous Kill,60000000,40081410,78481410,18481410,0.308024
12/11/2009,Invictus,60000000,37491364,124514011,64514011,1.07523
4/17/2009,State of Play,60000000,37017955,88832210,28832210,0.480537
2/12/1999,My Favorite Martian,60000000,36850101,36850101,-23149899,-0.385832
4/21/2006,The Sentinel,60000000,36280697,78080697,18080697,0.301345
9/21/2012,Trouble with the Curve,60000000,35763137,47818913,-12181087,-0.203018
10/10/2003,Intolerable Cruelty,60000000,35327628,121327628,61327628,1.02213
1/10/1997,The Relic,60000000,33956608,33956608,-26043392,-0.434057
4/3/1998,Mercury Rising,60000000,32983332,32983332,-27016668,-0.450278
9/15/2000,Almost Famous,60000000,32522352,47371191,-12628809,-0.21048
2/7/2019,Cold Pursuit,60000000,32138862,62599159,2599159,0.0433193
12/6/2002,Analyze That,60000000,32122249,54994757,-5005243,-0.0834207
4/24/2009,The Soloist,60000000,31853584,38522450,-21477550,-0.357959
8/21/2013,The Mortal Instruments: City of Bones,60000000,31165421,75965567,15965567,0.266093
11/3/2000,The Legend of Bagger Vance,60000000,30695227,39235486,-20764514,-0.346075
2/22/2002,Dragonfly,60000000,30063805,30317425,-29682575,-0.49471
5/13/2011,Priest,60000000,29136626,84154026,24154026,0.402567
6/16/2006,Garfield: A Tail of Two Kitties,60000000,28426747,147985373,87985373,1.46642
4/29/2005,XXX: State of the Union,60000000,26873932,71073932,11073932,0.184566
8/15/1997,Event Horizon,60000000,26673242,26673953,-33326047,-0.555434
7/2/2003,Sinbad: Legend of the Seven Seas,60000000,26483452,80767884,20767884,0.346131
7/8/2005,Dark Water,60000000,25473093,49473093,-10526907,-0.175448
8/14/1998,The Avengers,60000000,23385416,48585416,-11414584,-0.190243
9/15/2006,The Black Dahlia,60000000,22672813,49238525,-10761475,-0.179358
3/26/1999,EDtv,60000000,22508689,35319689,-24680311,-0.411339
12/25/2008,The Spirit,60000000,19806188,39006188,-20993812,-0.349897
10/19/2001,The Last Castle,60000000,18208078,20541668,-39458332,-0.657639
1/23/2009,Inkheart,60000000,17303424,66655938,6655938,0.110932
2/18/2020,Monster Hunter,60000000,15104790,44400541,-15599459,-0.259991
1/14/2000,Supernova,60000000,14218868,14816494,-45183506,-0.753058
9/22/2006,Flyboys,60000000,13090630,14816379,-45183621,-0.75306
2/14/2014,Winter’s Tale,60000000,12600231,29575033,-30424967,-0.507083
10/9/1998,Holy Man,60000000,12069719,12069719,-47930281,-0.798838
7/11/2008,Meet Dave,60000000,11803254,50648806,-9351194,-0.155853
8/12/2005,The Great Raid,60000000,10166502,10597070,-49402930,-0.823382
7/2/2016,Rock Dog,60000000,9420546,24148488,-35851512,-0.597525
1/21/2015,Mortdecai,60000000,7696134,30396134,-29603866,-0.493398
1/11/2008,In the Name of the King: A Dungeon Siege Tale,60000000,4775656,13233220,-46766780,-0.779446
10/24/2003,Beyond Borders,60000000,4426297,11427090,-48572910,-0.809549
2/4/2016,Xi You Ji zhi Sun Wu Kong San Da Bai Gu Jing,60000000,709982,194058503,134058503,2.23431
8/30/2019,The Informer,60000000,300460,2369336,-57630664,-0.960511
12/11/2015,The Ridiculous 6,60000000,0,0,-60000000,-1
3/15/2018,Sherlock Gnomes,59000000,43242871,87527651,28527651,0.48352
1/18/2019,The Kid Who Would Be King,59000000,16790790,28296983,-30703017,-0.52039
2/9/2016,Deadpool,58000000,363070709,784157111,726157111,12.52
12/25/2014,American Sniper,58000000,350126372,547326372,489326372,8.43666
10/14/2015,Goosebumps,58000000,80069458,158911568,100911568,1.73985
5/25/1988,Rambo III,58000000,53715611,188715611,130715611,2.25372
12/15/1995,Sabrina,58000000,53458319,87100000,29100000,0.501724
1/20/2012,Red Tails,58000000,49876377,50365498,-7634502,-0.131629
9/16/2005,Just Like Heaven,58000000,48318130,100687083,42687083,0.735984
6/7/2013,The Internship,58000000,44672764,93672764,35672764,0.615048
4/28/2000,The Flintstones in Viva Rock Vegas,58000000,35231365,59431365,1431365,0.0246787
4/4/2008,Leatherheads,58000000,31373938,41348628,-16651372,-0.287093
3/22/2017,Life,58000000,30234022,101815660,43815660,0.755442
12/18/2009,Did You Hear About the Morgans?,58000000,29580087,80480566,22480566,0.387596
12/12/2008,Che Part 1: The Argentine,58000000,1802521,31627370,-26372630,-0.454701
5/30/2008,Sex and the City,57500000,152647258,415247258,357747258,6.22169
9/10/2010,Resident Evil: Afterlife,57500000,60128566,295874190,238374190,4.14564
6/13/2012,That’s My Boy,57500000,36931089,58879681,1379681,0.0239945
10/17/1997,Devil’s Advocate,57000000,61007424,153007424,96007424,1.68434
2/17/2012,Ghost Rider: Spirit of Vengeance,57000000,51774002,149217355,92217355,1.61785
5/31/1996,Dragonheart,57000000,51364680,104364680,47364680,0.830959
11/12/2004,After the Sunset,57000000,28328132,38329114,-18670886,-0.327559
8/17/2001,Captain Corelli's Mandolin,57000000,25528495,62097495,5097495,0.0894297
12/25/2014,Into the Woods,56200000,128002372,212550576,156350576,2.78204
4/11/2003,Anger Management,56000000,135560942,195484552,139484552,2.4908
3/4/2005,The Pacifier,56000000,113006880,198006880,142006880,2.53584
4/2/2004,Walking Tall,56000000,46213824,47856383,-8143617,-0.145422
7/12/2015,Zhuo yao ji,56000000,32766,359295591,303295591,5.41599
10/2/2019,Joker,55000000,335451311,1072507517,1017507517,18.5001
7/6/1994,Forrest Gump,55000000,330151138,679838260,624838260,11.3607
12/14/2007,Alvin and the Chipmunks,55000000,217326974,362605033,307605033,5.59282
10/26/2018,Bohemian Rhapsody,55000000,216303339,887040610,832040610,15.128
2/11/2005,Hitch,55000000,177784257,366784257,311784257,5.6688
10/6/2000,Meet the Parents,55000000,166225040,330425040,275425040,5.00773
12/15/2006,The Pursuit of Happyness,55000000,162586036,307311093,252311093,4.58747
6/10/1995,Pocahontas,55000000,141579773,347100000,292100000,5.31091
12/15/1978,Superman,55000000,134218018,300200000,245200000,4.45818
6/28/1996,The Nutty Professor,55000000,128814019,273814019,218814019,3.97844
2/8/2017,Fifty Shades Darker,55000000,114434010,381367046,326367046,5.93395
10/11/2013,Captain Phillips,55000000,107136417,220648184,165648184,3.01179
7/16/1997,George Of The Jungle,55000000,105263257,174463257,119463257,2.17206
8/1/2003,American Wedding,55000000,104354205,232354205,177354205,3.22462
11/3/2017,Murder on the Orient Express,55000000,102826543,351767147,296767147,5.39577
9/26/2014,The Equalizer,55000000,101530738,192903624,137903624,2.50734
2/7/2018,Fifty Shades Freed,55000000,100407760,371985018,316985018,5.76336
5/26/1995,Casper,55000000,100328194,282300000,227300000,4.13273
4/9/2010,Date Night,55000000,98711404,152269033,97269033,1.76853
12/13/2002,Maid in Manhattan,55000000,93932896,163838217,108838217,1.97888
5/12/1995,Crimson Tide,55000000,91387195,159387195,104387195,1.89795
9/23/2005,Flightplan,55000000,89706988,214392904,159392904,2.89805
12/9/1994,Disclosure,55000000,83015089,212200000,157200000,2.85818
4/10/1998,City of Angels,55000000,78750909,198750909,143750909,2.61365
11/28/2014,Paddington,55000000,76223578,252410984,197410984,3.58929
4/28/2006,R.V.,55000000,71724497,87473024,32473024,0.590419
10/28/1994,Stargate,55000000,71565669,196565669,141565669,2.57392
10/10/2003,Kill Bill: Volume 1,55000000,70098138,176469428,121469428,2.20854
6/17/2011,Mr. Poppers's Penguins,55000000,68224452,189624452,134624452,2.44772
8/13/1999,Bowfinger,55000000,66458769,98699769,43699769,0.794541
4/16/2004,Kill Bill: Volume 2,55000000,66207920,153535982,98535982,1.79156
12/22/1989,Tango & Cash,55000000,63408614,63408614,8408614,0.152884
7/31/1992,Death Becomes Her,55000000,58422650,149022650,94022650,1.7095
5/26/2000,Shanghai Noon,55000000,56932305,71189835,16189835,0.294361
3/15/1996,Executive Decision,55000000,56679192,122079192,67079192,1.21962
10/31/2013,Free Birds,55000000,55750480,110387072,55387072,1.00704
5/22/1992,Alien 3,55000000,54927174,158500000,103500000,1.88182
4/18/2008,The Forbidden Kingdom,55000000,52075270,129075270,74075270,1.34682
12/8/2004,The Phantom of the Opera,55000000,51225796,153770052,98770052,1.79582
3/21/2014,Muppets Most Wanted,55000000,51178893,79312301,24312301,0.442042
12/20/1996,Evita,55000000,50047179,151947179,96947179,1.76268
8/18/2016,Kubo and the Two Strings,55000000,48023088,77548122,22548122,0.409966
4/8/2021,Mortal Kombat,55000000,42201013,83383351,28383351,0.516061
9/25/1998,Ronin,55000000,41610884,70692101,15692101,0.285311
11/24/2010,Burlesque,55000000,39440655,90552675,35552675,0.646412
10/11/1996,The Ghost and the Darkness,55000000,38564422,38564422,-16435578,-0.298829
10/24/2008,Changeling,55000000,35739802,113805580,58805580,1.06919
7/27/2012,The Watch,55000000,34353000,67130045,12130045,0.220546
3/14/2003,The Hunted,55000000,34234008,47213095,-7786905,-0.14158
6/4/1999,Instinct,55000000,34105207,34105207,-20894793,-0.379905
12/12/2003,Stuck On You,55000000,33832741,63537164,8537164,0.155221
2/29/2008,Semi-Pro,55000000,33479698,43980363,-11019637,-0.200357
2/23/2018,Annihilation,55000000,32732301,43070915,-11929085,-0.216892
10/14/2015,Crimson Peak,55000000,31090320,74966854,19966854,0.363034
3/28/2012,The Pirates! Band of Misfits,55000000,31051126,136143605,81143605,1.47534
6/10/2021,In the Heights,55000000,29879041,43583702,-11416298,-0.207569
12/2/2005,Aeon Flux,55000000,25857987,53913573,-1086427,-0.0197532
8/2/1996,Chain Reaction,55000000,21226204,60209334,5209334,0.0947152
8/16/1996,The Fan,55000000,18582965,18582965,-36417035,-0.662128
10/12/2007,Elizabeth: The Golden Age,55000000,16285240,74870866,19870866,0.361288
6/12/2009,Imagine That,55000000,16222392,22438144,-32561856,-0.592034
2/21/2003,Gods and Generals,55000000,12882934,12923936,-42076064,-0.765019
1/10/1997,Turbulence,55000000,11532774,11532774,-43467226,-0.790313
1/31/2013,Bullet to the Head,55000000,9489829,22597969,-32402031,-0.589128
9/22/2006,All the King's Men,55000000,7221458,9521458,-45478542,-0.826883
7/30/2004,Thunderbirds,55000000,6768055,28231444,-26768556,-0.486701
11/26/2004,Un long dimanche de fiançailles,55000000,6167817,69722444,14722444,0.267681
5/4/2007,Lucky You,55000000,5755286,6521829,-48478171,-0.881421
7/22/1998,Lolita,55000000,1147784,1147784,-53852216,-0.979131
9/20/2002,Eye See You,55000000,79161,1807990,-53192010,-0.967127
6/19/1981,Superman II,54000000,108185706,190400000,136400000,2.52593
3/22/2002,Blade 2,54000000,81676888,154338601,100338601,1.85812
7/14/2006,You Me and Dupree,54000000,75802010,130402010,76402010,1.41485
12/19/2008,Seven Pounds,54000000,69951824,166617328,112617328,2.08551
12/25/1990,The Godfather: Part III,54000000,66666062,66772386,12772386,0.236526
10/14/2005,Elizabethtown,54000000,26850426,50719373,-3280627,-0.0607524
8/1/2003,Gigli,54000000,6087542,7126002,-46873998,-0.868037
6/16/2000,Shaft,53012938,70327868,107190108,54177170,1.02196
8/5/2005,The Dukes of Hazzard,53000000,80270227,109848461,56848461,1.07261
10/16/2009,Law Abiding Citizen,53000000,73357727,131159781,78159781,1.47471
9/17/2015,Black Mass,53000000,62575678,98837872,45837872,0.864866
11/14/1997,Anastasia,53000000,58403409,139801096,86801096,1.63776
5/18/2001,Moulin Rouge,53000000,57386369,179199536,126199536,2.38112
11/2/2001,Domestic Disturbance,53000000,45207112,54207112,1207112,0.0227757
10/20/2006,Flags of Our Fathers,53000000,33602376,63657941,10657941,0.201093
4/6/2007,Grindhouse,53000000,25031037,50187789,-2812211,-0.0530606
10/16/1998,Beloved,53000000,22852487,22852487,-30147513,-0.568821
12/19/2012,Zero Dark Thirty,52500000,95720716,134612435,82112435,1.56405
12/25/2002,Catch Me if You Can,52000000,164606800,355612291,303612291,5.8387
7/2/2008,Mamma Mia!,52000000,144130063,602891655,550891655,10.5941
6/2/2006,The Break-Up,52000000,118703275,205727307,153727307,2.95629
2/12/2010,Valentine's Day,52000000,110485654,217569328,165569328,3.18403
11/22/1995,Casino,52000000,42438300,110400000,58400000,1.12308
8/5/2011,The Change-Up,52000000,37243418,75997067,23997067,0.461482
12/23/1998,The Thin Red Line,52000000,36400491,97709034,45709034,0.87902
12/22/1999,Man on the Moon,52000000,34580635,47407635,-4592365,-0.0883147
2/5/2010,From Paris With Love,52000000,24077427,53139168,1139168,0.0219071
4/16/2003,Bulletproof Monk,52000000,23010607,26922492,-25077508,-0.48226
6/23/2000,Me Myself & Irene,51000000,90570999,149270999,98270999,1.92688
8/4/2006,Barnyard: The Original Party Animals,51000000,72779000,118583844,67583844,1.32517
8/15/2018,Alpha,51000000,35851379,99624873,48624873,0.953429
11/22/2006,Deck the Halls,51000000,35093569,46815807,-4184193,-0.082043
7/10/2020,Greyhound,50300000,0,0,-50300000,-1
3/4/2011,The Adjustment Bureau,50200000,62495645,126931325,76731325,1.52851
11/19/2009,The Twilight Saga: New Moon,50000000,296623634,687557727,637557727,12.7512
5/18/2001,Shrek,50000000,267655011,491812794,441812794,8.83626
6/29/2012,Ted,50000000,218665740,556016627,506016627,10.1203
6/5/2014,22 Jump Street,50000000,191719337,331333876,281333876,5.62668
6/14/1991,Robin Hood: Prince of Thieves,50000000,165493908,390500000,340500000,6.81
12/13/1996,Jerry Maguire,50000000,153952592,273552592,223552592,4.47105
12/25/2015,Daddy’s Home,50000000,150357137,241504989,191504989,3.8301
12/24/1997,As Good as it Gets,50000000,148478011,314111923,264111923,5.28224
12/25/1998,Patch Adams,50000000,135014968,202173000,152173000,3.04346
6/16/2016,Central Intelligence,50000000,127440871,217194805,167194805,3.3439
12/18/2013,Anchorman 2: The Legend Continues,50000000,127413176,172246223,122246223,2.44492
6/10/2011,Super 8,50000000,127004179,257972745,207972745,4.15945
6/28/2002,Mr. Deeds,50000000,126293452,171269535,121269535,2.42539
3/17/2000,Erin Brockovich,50000000,125548685,257805243,207805243,4.1561
11/21/2018,Creed II,50000000,115715889,213591522,163591522,3.27183
2/8/2018,Peter Rabbit,50000000,115234093,346727372,296727372,5.93455
2/7/2003,How to Lose a Guy in 10 Days,50000000,105807520,178503788,128503788,2.57008
11/11/1994,Interview with the Vampire,50000000,105264608,223564608,173564608,3.47129
12/14/2018,The Mule,50000000,103804407,173453994,123453994,2.46908
12/19/2008,Yes Man,50000000,97690976,225990976,175990976,3.51982
2/28/2014,Non-Stop,50000000,91742160,222383055,172383055,3.44766
12/25/1998,Stepmom,50000000,91137662,159745279,109745279,2.19491
8/9/2013,Disney Planes,50000000,90282580,238059569,188059569,3.76119
3/10/2006,Failure to Launch,50000000,88715192,128402901,78402901,1.56806
3/24/2006,Inside Man,50000000,88634237,185798265,135798265,2.71597
7/26/2017,The Emoji Movie,50000000,86089513,216564840,166564840,3.3313
7/29/2011,Crazy Stupid Love,50000000,84351197,147142328,97142328,1.94285
12/22/2017,The Post,50000000,81903458,179769457,129769457,2.59539
2/5/1999,Payback,50000000,81526121,161626121,111626121,2.23252
6/9/1995,Congo,50000000,81022333,152022333,102022333,2.04045
3/20/2009,Knowing,50000000,79957634,186450317,136450317,2.72901
3/18/2005,The Ring Two,50000000,75941727,161941727,111941727,2.23883
12/23/2011,We Bought a Zoo,50000000,75624550,118729073,68729073,1.37458
9/23/2011,Moneyball,50000000,75605492,111300835,61300835,1.22602
6/11/2004,Garfield: The Movie,50000000,75367693,208094550,158094550,3.16189
11/24/2004,Christmas with the Kranks,50000000,73701902,96469187,46469187,0.929384
3/17/2006,V for Vendetta,50000000,70511035,130214162,80214162,1.60428
3/10/1995,Outbreak,50000000,67823573,190023573,140023573,2.80047
3/13/2009,Race to Witch Mountain,50000000,67172595,105103784,55103784,1.10208
9/24/2004,The Forgotten,50000000,66711892,117211892,67211892,1.34424
6/22/2005,Herbie: Fully Loaded,50000000,66010682,144110682,94110682,1.88221
2/7/2003,Shanghai Knights,50000000,60470220,88316835,38316835,0.766337
7/17/2014,Planes: Fire and Rescue,50000000,59157732,156399644,106399644,2.12799
2/10/2006,Curious George,50000000,58640119,71052604,21052604,0.421052
4/4/2012,American Reunion,50000000,56758835,236799211,186799211,3.73598
1/25/2013,Hansel & Gretel: Witch Hunters,50000000,55703475,214949716,164949716,3.29899
2/18/2011,I am Number Four,50000000,55100437,146195159,96195159,1.9239
9/28/2001,Don’t Say a Word,50000000,54997476,104488383,54488383,1.08977
1/15/2016,13 Hours: The Secret Soldiers of Benghazi,50000000,52853219,69411370,19411370,0.388227
5/8/2002,Unfaithful,50000000,52752475,119114494,69114494,1.38229
8/23/2017,American Made,50000000,51342000,135569212,85569212,1.71138
11/23/2005,Syriana,50000000,50824620,92690959,42690959,0.853819
9/10/2004,Resident Evil: Apocalypse,50000000,50740078,125168734,75168734,1.50337
10/17/2014,The Book of Life,50000000,50151543,97651543,47651543,0.953031
2/14/1997,Absolute Power,50000000,50068310,50068310,68310,0.0013662
2/10/2006,Firewall,50000000,48751189,82751189,32751189,0.655024
9/12/1997,The Game,50000000,48265581,80369970,30369970,0.607399
8/22/1997,G.I. Jane,50000000,48169156,48169156,-1830844,-0.0366169
8/8/2014,Into the Storm,50000000,47602194,150429371,100429371,2.00859
10/10/2014,The Judge,50000000,47119388,76073556,26073556,0.521471
4/21/2006,Silent Hill,50000000,46982632,94704227,44704227,0.894085
2/12/2021,Tom and Jerry,50000000,46041123,132055573,82055573,1.64111
9/19/2019,Rambo: Last Blood,50000000,44819352,91419352,41419352,0.828387
8/11/2000,The Replacements,50000000,44737059,50054511,54511,0.00109022
7/29/1998,The Negotiator,50000000,44705766,49105766,-894234,-0.0178847
8/19/2016,War Dogs,50000000,43034523,86234503,36234503,0.72469
5/25/1994,Beverly Hills Cop III,50000000,42586861,119180938,69180938,1.38362
6/15/1990,Gremlins 2: The New Batch,50000000,41476097,41476097,-8523903,-0.170478
9/26/1997,The Peacemaker,50000000,41263140,62967368,12967368,0.259347
10/3/2003,Out of Time,50000000,41083108,55489826,5489826,0.109797
11/12/2004,Bridget Jones: The Edge Of Reason,50000000,40203020,263894551,213894551,4.27789
2/11/2000,The Beach,50000000,39778599,39778599,-10221401,-0.204428
6/10/2005,The Adventures of Sharkboy and Lavagirl in 3-D,50000000,39177684,69425966,19425966,0.388519
2/18/1994,On Deadly Ground,50000000,38590458,38590458,-11409542,-0.228191
11/25/2009,Ninja Assassin,50000000,38122883,62209892,12209892,0.244198
5/28/2004,Raising Helen,50000000,37485528,49842431,-157569,-0.00315138
5/19/2016,The Nice Guys,50000000,36261763,59596747,9596747,0.191935
9/17/1999,For Love of the Game,50000000,35188640,46112640,-3887360,-0.0777472
12/11/1998,Jack Frost,50000000,34645374,34645374,-15354626,-0.307093
6/4/2010,Marmaduke,50000000,33644788,89895930,39895930,0.797919
6/28/1996,Striptease,50000000,33109743,113309743,63309743,1.26619
10/15/2010,Hereafter,50000000,32746941,108660270,58660270,1.17321
4/19/2002,Murder by Numbers,50000000,31874869,56643267,6643267,0.132865
10/6/1995,Assassins,50000000,30306268,83306268,33306268,0.666125
12/22/2017,Hostiles,50000000,29819114,36976336,-13023664,-0.260473
2/5/2016,Zoolander 2,50000000,28848693,55348693,5348693,0.106974
1/16/2009,Defiance,50000000,28644813,52987754,2987754,0.0597551
2/9/2007,Hannibal Rising,50000000,27669725,80583311,30583311,0.611666
10/15/1999,The Story of Us,50000000,27100030,27100030,-22899970,-0.457999
3/22/2013,The Host,50000000,26623701,64477051,14477051,0.289541
3/28/2003,Basic,50000000,26599248,42598498,-7401502,-0.14803
3/11/2015,Run All Night,50000000,26461644,71561644,21561644,0.431233
8/9/2002,Blood Work,50000000,26199517,26199517,-23800483,-0.47601
2/13/2009,The International,50000000,25450527,53850527,3850527,0.0770105
8/9/1996,Escape from L.A.,50000000,25426861,25426861,-24573139,-0.491463
2/27/2004,Twisted,50000000,25195050,40119848,-9880152,-0.197603
12/25/2017,All the Money in the World,50000000,25106325,56890649,6890649,0.137813
12/10/2004,The Life Aquatic with Steve Zissou,50000000,24006726,34806726,-15193274,-0.303865
8/4/1999,The Iron Giant,50000000,23159305,31333917,-18666083,-0.373322
4/10/2019,Hellboy,50000000,21903748,53956480,3956480,0.0791296
4/8/2011,Your Highness,50000000,21596445,26121638,-23878362,-0.477567
12/30/2015,Snowden,50000000,21587519,35380918,-14619082,-0.292382
9/30/2011,Dream House,50000000,21302340,41642166,-8357834,-0.167157
6/24/2016,Free State of Jones,50000000,20810036,23237252,-26762748,-0.535255
9/4/2009,Gamer,50000000,20534907,42002029,-7997971,-0.159959
2/25/2005,Man of the House,50000000,19699706,22099706,-27900294,-0.558006
2/21/2003,The Life of David Gale,50000000,19694635,28920188,-21079812,-0.421596
2/14/2013,Beautiful Creatures,50000000,19452138,60282876,10282876,0.205658
9/30/2005,Into the Blue,50000000,18782227,41982227,-8017773,-0.160355
9/14/2007,Eastern Promises,50000000,17181265,56077088,6077088,0.121542
7/1/1994,Baby’s Day Out,50000000,16581575,16581575,-33418425,-0.668369
11/12/1999,The Messenger: The Story of Joan of Arc,50000000,14271297,14271297,-35728703,-0.714574
11/18/2021,King Richard,50000000,13701474,21901474,-28098526,-0.561971
11/3/1995,Fair Game,50000000,11497497,26097497,-23902503,-0.47805
2/25/2011,Drive Angry,50000000,10721033,41042583,-8957417,-0.179148
11/7/1997,Mad City,50000000,10561038,10561038,-39438962,-0.788779
10/13/1995,The Scarlet Letter,50000000,10359006,10359006,-39640994,-0.79282
10/14/2005,Domino,50000000,10169202,23574057,-26425943,-0.528519
10/13/1995,Jade,50000000,9812870,9812870,-40187130,-0.803743
2/27/2009,Street Fighter: The Legend of Chun-Li,50000000,8742261,12660287,-37339713,-0.746794
3/29/2002,Death to Smoochy,50000000,8355815,8374062,-41625938,-0.832519
1/26/2018,Early Man,50000000,8267544,45285890,-4714110,-0.0942822
11/13/2009,The Boat That Rocked,50000000,8017467,37472651,-12527349,-0.250547
1/30/2004,The Big Bounce,50000000,6471394,6626115,-43373885,-0.867478
3/3/2000,What Planet Are You From?,50000000,6291602,6291602,-43708398,-0.874168
2/1/2019,Liu Lang Di Qiu,50000000,5875487,727846450,677846450,13.5569
11/1/2019,Arctic Dogs,50000000,5801249,9694569,-40305431,-0.806109
1/31/2020,The Rhythm Section,50000000,5437971,5983043,-44016957,-0.880339
4/17/2015,Child 44,50000000,1224330,8004221,-41995779,-0.839916
1/23/2009,Outlander,50000000,166003,1250617,-48749383,-0.974988
8/23/2012,Upside Down,50000000,102118,26387039,-23612961,-0.472259
9/7/2012,Shanghai,50000000,46425,15505922,-34494078,-0.689882
,Hannibal the Conqueror,50000000,0,0,-50000000,-1
8/8/2019,Dora and the Lost City of Gold,49000000,60477943,120597108,71597108,1.46117
11/2/2001,The One,49000000,43905746,72689126,23689126,0.483452
3/4/2015,Chappie,49000000,31569268,105002056,56002056,1.1429
7/11/1990,The Adventures of Ford Fairlane,49000000,20423389,20423389,-28576611,-0.583196
9/7/2012,Anna Karenina,49000000,12816367,71004627,22004627,0.449074
5/24/1989,Indiana Jones and the Last Crusade,48000000,197171806,474171806,426171806,8.87858
10/18/2002,The Ring,48000000,129094024,248218486,200218486,4.17122
12/27/2000,Traffic,48000000,124107476,208300000,160300000,3.33958
3/29/2002,Panic Room,48000000,95308367,196308367,148308367,3.08976
1/2/2015,Taken 3,48000000,89256424,327656424,279656424,5.82618
10/9/2019,Zombieland: Double Tap,48000000,73118130,122266018,74266018,1.54721
8/6/1999,The Thomas Crown Affair,48000000,69304264,124304264,76304264,1.58967
11/16/2018,Instant Family,48000000,67363237,119736188,71736188,1.4945
11/5/1999,The Bone Collector,48000000,66488090,151463090,103463090,2.15548
10/1/1999,Three Kings,48000000,60652036,107752036,59752036,1.24483
1/22/2010,Tooth Fairy,48000000,60022256,112610386,64610386,1.34605
8/17/2001,Rat Race,48000000,56607223,86607223,38607223,0.804317
9/7/2007,3:10 to Yuma,48000000,53606916,71171825,23171825,0.482746
8/13/2001,K-PAX,48000000,50315140,64978140,16978140,0.353711
12/25/2001,Kate and Leopold,48000000,47095453,70937778,22937778,0.47787
10/20/2000,Bedazzled,48000000,37879996,90376224,42376224,0.882838
6/26/1998,Out of Sight,48000000,37562568,77562568,29562568,0.615887
12/14/1984,The Cotton Club,48000000,25928721,25928721,-22071279,-0.459818
11/13/2019,Charlie’s Angels,48000000,17801306,73180003,25180003,0.524583
1/25/2008,Rambo,47500000,42754105,113244290,65744290,1.38409
7/13/2016,The Infiltrator,47500000,15436808,22152137,-25347863,-0.533639
6/15/1990,Dick Tracy,47000000,103738726,162738726,115738726,2.46253
11/9/2016,Arrival,47000000,100546139,202863303,155863303,3.31624
6/14/1996,The Cable Guy,47000000,60240295,102825796,55825796,1.18778
11/19/1993,Addams Family Values,47000000,46293855,46293855,-706145,-0.0150244
4/22/2009,Earth,47000000,32011576,116773317,69773317,1.48454
10/19/2001,Riding in Cars with Boys,47000000,29781453,29781453,-17218547,-0.366352
1/5/2007,Happily N'Ever After,47000000,15849032,37923818,-9076182,-0.19311
11/27/2002,Solaris,47000000,14970038,14970038,-32029962,-0.681489
6/18/2010,Jonah Hex,47000000,10547117,11022696,-35977304,-0.765475
2/23/1996,Mary Reilly,47000000,5707094,12900000,-34100000,-0.725532
12/23/2016,Silence,46500000,7100177,23726626,-22773374,-0.48975
10/4/2012,Mr. Nobody,46500000,3622,22254,-46477746,-0.999521
6/20/1997,My Best Friend's Wedding,46000000,126813153,298923419,252923419,5.49834
7/20/2001,America's Sweethearts,46000000,93607673,160648493,114648493,2.49236
11/22/1996,Star Trek: First Contact,46000000,92027888,150000000,104000000,2.26087
5/24/2002,Insomnia,46000000,67263182,113622499,67622499,1.47005
9/19/2013,Prisoners,46000000,61002302,113361720,67361720,1.46439
7/12/1996,Courage Under Fire,46000000,59003384,100833145,54833145,1.19202
9/17/1982,Inchon,46000000,4408636,4408636,-41591364,-0.90416
11/5/2015,Arthur and the War of Two Worlds,45500000,347136,36180824,-9319176,-0.204817
3/21/1997,Liar Liar,45000000,181410615,302710615,257710615,5.7269
11/20/1998,A Bug's Life,45000000,162798565,363095319,318095319,7.06878
9/27/2012,Taken 2,45000000,139854287,377807404,332807404,7.39572
5/27/1994,The Flintstones,45000000,130531208,358500000,313500000,6.96667
10/24/2003,Scary Movie 3,45000000,110000082,155200000,110200000,2.44889
12/22/2000,Miss Congeniality,45000000,106807667,213420951,168420951,3.74269
12/21/2017,Pitch Perfect 3,45000000,104897530,185736412,140736412,3.12748
7/11/2008,Journey to the Center of the Earth,45000000,101704370,243180937,198180937,4.40402
12/17/1993,The Pelican Brief,45000000,100768056,187995859,142995859,3.17769
8/11/2004,The Princess Diaries 2: Royal Engagement,45000000,95149435,122071435,77071435,1.7127
12/25/2007,The Bucket List,45000000,93466502,174807445,129807445,2.88461
7/20/1994,The Client,45000000,92115211,117615211,72615211,1.61367
11/23/2011,The Muppets,45000000,88625922,160971922,115971922,2.57715
6/5/1992,Patriot Games,45000000,83287363,178100000,133100000,2.95778
5/13/2005,Monster-in-Law,45000000,82931301,155931301,110931301,2.46514
10/5/2001,Training Day,45000000,76261036,104505362,59505362,1.32234
10/5/2016,The Girl on the Train,45000000,75395035,174278214,129278214,2.87285
12/24/1999,Galaxy Quest,45000000,71423726,90523726,45523726,1.01164
7/4/2001,Scary Movie 2,45000000,71277420,141189101,96189101,2.13754
8/21/1998,Blade,45000000,70141876,131237688,86237688,1.91639
1/14/2005,Coach Carter,45000000,67264877,76665507,31665507,0.703678
3/19/2010,The Bounty Hunter,45000000,67061228,135808837,90808837,2.01797
4/12/2002,Changing Lanes,45000000,66790248,66790248,21790248,0.484228
4/11/1997,Anaconda,45000000,65598907,136998907,91998907,2.04442
1/20/2006,Underworld: Evolution,45000000,62318875,113417762,68417762,1.52039
11/22/2019,A Beautiful Day in the Neighborhood,45000000,61696436,68550222,23550222,0.523338
8/4/2000,Coyote Ugly,45000000,60786269,113916474,68916474,1.53148
11/7/2003,Love Actually,45000000,59472278,246821053,201821053,4.48491
8/9/1996,Jack,45000000,58617334,58617334,13617334,0.302607
10/7/1994,The Specialist,45000000,57362581,170362581,125362581,2.78584
12/8/2016,Office Christmas Party,45000000,54767494,115097874,70097874,1.55773
8/16/1996,Tin Cup,45000000,53854588,75854588,30854588,0.685658
11/23/2005,Yours Mine and Ours,45000000,53359917,72359917,27359917,0.607998
5/13/2005,Kicking and Screaming,45000000,52842724,55842724,10842724,0.240949
4/29/2005,The Hitchhiker's Guide to the Galaxy,45000000,51019112,102746214,57746214,1.28325
9/21/2007,Resident Evil: Extinction,45000000,50648679,149871103,104871103,2.33047
12/25/2004,Fat Albert,45000000,48114556,48563556,3563556,0.0791901
7/6/2012,Savages,45000000,47323100,82513490,37513490,0.833633
9/30/1994,The River Wild,45000000,46815000,94215000,49215000,1.09367
5/22/2014,Blended,45000000,46290741,127990741,82990741,1.84424
6/15/2016,All Eyez on Me,45000000,44922302,57697426,12697426,0.282165
3/26/2021,Peter Rabbit 2: The Runaway,45000000,40391464,152550437,107550437,2.39001
1/13/2006,Last Holiday,45000000,38399961,43343247,-1656753,-0.0368167
3/3/2006,16 Blocks,45000000,36895141,65595141,20595141,0.45767
7/14/1995,The Indian in the Cupboard,45000000,35627222,35627222,-9372778,-0.208284
9/10/2004,Cellular,45000000,32003620,61453420,16453420,0.365632
10/31/2019,Doctor Sleep,45000000,31581712,71856239,26856239,0.596805
7/28/2006,The Ant Bully,45000000,28142535,49610898,4610898,0.102464
4/11/2003,Johnny English,45000000,28013509,161735791,116735791,2.59413
12/14/1984,Dune,45000000,27447471,27503491,-17496509,-0.388811
7/31/2009,Aliens in the Attic,45000000,25200412,59551283,14551283,0.323362
9/14/2007,Across the Universe,45000000,24343673,29367143,-15632857,-0.347397
12/26/2008,Revolutionary Road,45000000,22951340,79604820,34604820,0.768996
8/29/2008,Babylon A.D.,45000000,22532572,70216497,25216497,0.560367
12/13/2019,Richard Jewell,45000000,22345542,43100570,-1899430,-0.0422096
11/4/1994,Frankenstein,45000000,22006296,112006296,67006296,1.48903
10/4/1996,The Glimmer Man,45000000,20404841,36404841,-8595159,-0.191004
5/1/2019,UglyDolls,45000000,20150241,28363146,-16636854,-0.369708
7/17/1996,Multiplicity,45000000,20133326,20133326,-24866674,-0.552593
1/19/2001,The Pledge,45000000,19719930,29406132,-15593868,-0.34653
12/16/2005,The Producers: The Movie Musical,45000000,19398532,32952995,-12047005,-0.267711
6/7/1996,The Phantom,45000000,17220599,17220599,-27779401,-0.61732
7/1/2005,Rebound,45000000,16809014,17492014,-27507986,-0.611289
2/19/2010,The Ghost Writer,45000000,15541549,65532491,20532491,0.456278
12/22/2000,All the Pretty Horses,45000000,15527125,18120267,-26879733,-0.597327
9/5/2008,Bangkok Dangerous,45000000,15298133,46598133,1598133,0.0355141
12/20/1995,Nixon,45000000,13668249,34668249,-10331751,-0.229594
9/7/2012,Dredd,45000000,13414714,41467606,-3532394,-0.0784976
10/28/2011,The Rum Diary,45000000,13109815,21544732,-23455268,-0.521228
1/30/1998,Deep Rising,45000000,11203026,11203026,-33796974,-0.751044
12/21/2018,Welcome to Marwen,45000000,10763520,13086137,-31913863,-0.709197
11/29/2019,Bloodshot,45000000,10021787,37321081,-7678919,-0.170643
10/21/2011,Johnny English Reborn,45000000,8406711,164640401,119640401,2.65868
9/26/2008,Miracle at St. Anna,45000000,7916887,9676497,-35323503,-0.784967
4/5/2002,Big Trouble,45000000,7262288,8488871,-36511129,-0.811358
12/21/2006,Man cheng jin dai huang jin jia,45000000,6566773,76904429,31904429,0.708987
11/16/2007,Love in the Time of Cholera,45000000,4617608,31077418,-13922582,-0.309391
12/25/2002,Pinocchio,45000000,3681811,31681811,-13318189,-0.29596
1/31/1997,Shadow Conspiracy,45000000,2154540,2154540,-42845460,-0.952121
6/16/2012,Foodfight!,45000000,0,73706,-44926294,-0.998362
11/11/2020,Hillbilly Elegy,45000000,0,38852,-44961148,-0.999137
10/11/2012,Argo,44500000,136025503,227140757,182640757,4.10429
8/6/1993,The Fugitive,44000000,183875760,353715317,309715317,7.03898
5/22/1985,Rambo: First Blood Part II,44000000,150415432,300400000,256400000,5.82727
10/18/1996,Sleepers,44000000,53300852,165600852,121600852,2.76366
7/30/2010,Charlie St. Cloud,44000000,31206263,48478084,4478084,0.101775
2/2/1996,The Juror,44000000,22730924,22730924,-21269076,-0.483388
2/6/2014,The Interview,44000000,6105175,12342632,-31657368,-0.719486
11/19/1980,Heaven's Gate,44000000,3484331,3484523,-40515477,-0.920806
6/28/2013,The Heat,43000000,159581587,229727774,186727774,4.34251
12/19/2000,Finding Forrester,43000000,51768623,80013623,37013623,0.860782
4/14/2000,28 Days,43000000,37035515,62063972,19063972,0.443348
5/13/2005,Danny the Dog,43000000,24537621,49037621,6037621,0.14041
4/12/2002,The Sweetest Thing,43000000,24430272,63078756,20078756,0.466948
10/25/2018,The Girl in the Spider’s Web,43000000,14828555,34983342,-8016658,-0.186434
10/7/2016,A Monster Calls,43000000,3740823,46414530,3414530,0.0794077
1/28/2011,The Mechanic,42500000,29121498,76347393,33847393,0.796409
6/30/1993,The Firm,42000000,158340892,270340892,228340892,5.43669
3/14/2012,21 Jump Street,42000000,138447667,202812429,160812429,3.82887
5/28/1999,Notting Hill,42000000,116089678,363718196,321718196,7.65996
12/25/2019,Little Women,42000000,108095955,218895434,176895434,4.2118
6/21/2000,Chicken Run,42000000,106793915,227793915,185793915,4.42366
1/16/2004,Along Came Polly,42000000,88073507,173044410,131044410,3.12011
7/1/1992,Boomerang,42000000,70052444,131052444,89052444,2.1203
7/10/2009,Brüno,42000000,60054530,138708527,96708527,2.30258
6/12/2063,Cleopatra,42000000,57000000,71000000,29000000,0.690476
5/12/2017,Snatched,42000000,45852178,57852177,15852177,0.377433
10/10/2012,Here Comes the Boom,42000000,45290318,73239258,31239258,0.743792
4/5/2002,High Crimes,42000000,41543207,63781100,21781100,0.518598
11/15/1996,The Mirror Has Two Faces,42000000,41267469,41267469,-732531,-0.0174412
3/11/2011,Red Riding Hood,42000000,37662162,91678442,49678442,1.18282
1/25/2002,The Mothman Prophecies,42000000,35228696,56438555,14438555,0.343775
7/14/1989,Licence to Kill,42000000,34667015,156167015,114167015,2.71826
12/20/2018,Holmes & Watson,42000000,30568743,41926605,-73395,-0.0017475
1/27/2012,One for the Money,42000000,26414527,36197221,-5802779,-0.138161
3/9/2001,15 Minutes,42000000,24375436,56331864,14331864,0.341235
9/16/2005,Lord of War,42000000,24149632,60437727,18437727,0.438993
5/28/1993,Super Mario Bros.,42000000,20844907,20844907,-21155093,-0.503693
10/2/1992,Hero,42000000,19487173,66787173,24787173,0.590171
1/27/2012,Man on a Ledge,42000000,18620000,49621440,7621440,0.181463
12/3/2010,The Warrior's Way,42000000,5666340,8514325,-33485675,-0.797278
4/18/1997,McHale's Navy,42000000,4408420,4408420,-37591580,-0.895038
5/28/2010,Micmacs,42000000,1259693,18821576,-23178424,-0.551867
,Les Bronzés 3: amis pour la vie,42000000,0,83833602,41833602,0.996038
4/10/2015,Pourquoi j'ai pas mangé mon père,42000000,0,15451663,-26548337,-0.632103
11/8/2002,8 Mile,41000000,116724075,245768384,204768384,4.99435
5/24/2019,Rocketman,41000000,96368160,192137020,151137020,3.68627
5/11/2001,A Knight’s Tale,41000000,56083966,100622586,59622586,1.45421
8/22/2003,The Medallion,41000000,22108977,22108977,-18891023,-0.460757
10/14/2011,The Big Year,41000000,7204138,7684524,-33315476,-0.812573
1/21/2022,The King’s Daughter,40500000,0,0,-40500000,-1
1/15/1999,The Sixth Sense,40000000,293506292,672806292,632806292,15.8202
7/15/2005,Wedding Crashers,40000000,209218368,283218368,243218368,6.08046
6/11/2010,The Karate Kid,40000000,176591618,351774938,311774938,7.79437
5/15/2019,John Wick: Chapter 3 — Parabellum,40000000,171016727,325674995,285674995,7.14187
2/11/2015,Fifty Shades of Grey,40000000,166167230,570794950,530794950,13.2699
11/27/2019,Knives Out,40000000,165364060,312952178,272952178,6.8238
6/19/2009,The Proposal,40000000,163958031,314709717,274709717,6.86774
12/12/2013,American Hustle,40000000,150098456,257858943,217858943,5.44647
12/25/2003,Cheaper by the Dozen,40000000,138614544,190212113,150212113,3.7553
7/25/2014,Lucy,40000000,126573960,457507776,417507776,10.4377
12/25/2013,Lone Survivor,40000000,125095601,149804632,109804632,2.74512
11/22/1989,Back to the Future Part II,40000000,118450002,331971881,291971881,7.2993
9/24/1999,Double Jeopardy,40000000,116735231,177835231,137835231,3.44588
7/25/2003,Spy Kids 3-D: Game Over,40000000,111760631,167851995,127851995,3.1963
7/24/1996,A Time to Kill,40000000,108766007,152266007,112266007,2.80665
7/1/1992,A League of Their Own,40000000,107533925,132440066,92440066,2.311
6/9/2016,The Conjuring 2: The Enfield Poltergeist,40000000,102470008,310201399,270201399,6.75503
10/1/2010,The Social Network,40000000,96962694,224922135,184922135,4.62305
8/7/2009,Julie & Julia,40000000,94125426,131516178,91516178,2.2879
2/6/2009,He's Just Not That Into You,40000000,93953653,181053657,141053657,3.52634
2/9/2017,John Wick: Chapter Two,40000000,92029184,171317271,131317271,3.28293
1/14/2016,Ride Along 2,40000000,90862685,124827316,84827316,2.12068
4/14/2006,Scary Movie 4,40000000,90710620,178710620,138710620,3.46777
3/26/2015,Get Hard,40000000,90411453,111711453,71711453,1.79279
2/4/2000,Scream 3,40000000,89138076,161838076,121838076,3.04595
5/24/1990,Back to the Future Part III,40000000,88055283,244087268,204087268,5.10218
10/11/2016,The Accountant,40000000,86260045,152962083,112962083,2.82405
11/13/2014,Dumb and Dumber To,40000000,86208010,156553592,116553592,2.91384
4/23/2014,The Other Woman,40000000,83911193,195111193,155111193,3.87778
11/13/1992,Bram Stoker's Dracula,40000000,82522790,215862692,175862692,4.39657
2/17/2006,Eight Below,40000000,81612565,120455994,80455994,2.0114
12/24/1999,The Talented Mr. Ripley,40000000,81292135,128792135,88792135,2.2198
9/24/2015,The Intern,40000000,75764672,197115710,157115710,3.92789
9/25/1992,The Last of the Mohicans,40000000,75505856,75505856,35505856,0.887646
10/29/2004,Ray,40000000,75305995,124823094,84823094,2.12058
4/1/2005,Sin City,40000000,74103820,158527918,118527918,2.9632
10/14/2015,Bridge of Spies,40000000,72313754,162498338,122498338,3.06246
2/22/2008,Vantage Point,40000000,72266306,150886329,110886329,2.77216
3/20/2009,I Love You Man,40000000,72013010,92302502,52302502,1.30756
11/9/2001,Shallow Hal,40000000,70836296,70836296,30836296,0.770907
12/20/1991,JFK,40000000,70405498,205400000,165400000,4.135
1/27/2006,Big Momma's House 2,40000000,70165972,137047376,97047376,2.42618
8/22/2019,Angel Has Fallen,40000000,69030436,133365452,93365452,2.33414
9/19/2018,The House with a Clock in its Walls,40000000,68549695,131457147,91457147,2.28643
11/3/2016,Hacksaw Ridge,40000000,67209615,169023926,129023926,3.2256
3/2/2001,The Mexican,40000000,66808615,145238250,105238250,2.63096
8/28/2009,The Final Destination,40000000,66477700,187384627,147384627,3.68462
3/7/2021,The Conjuring: The Devil Made Me Do It,40000000,65565074,200205869,160205869,4.00515
4/17/2009,17 Again,40000000,64167069,139474906,99474906,2.48687
2/18/2011,Unknown,40000000,63686397,136123083,96123083,2.40308
6/4/2010,Get Him to the Greek,40000000,61153526,92994927,52994927,1.32487
11/21/2003,Gothika,40000000,59588068,141484812,101484812,2.53712
11/30/2001,Behind Enemy Lines,40000000,58855732,58855732,18855732,0.471393
3/18/2011,The Lincoln Lawyer,40000000,58009200,87145086,47145086,1.17863
10/15/2004,Shall We Dance?,40000000,57887882,118097882,78097882,1.95245
8/25/2006,Invincible,40000000,57806952,58501127,18501127,0.462528
2/15/2013,Escape From Planet Earth,40000000,57012977,74156610,34156610,0.853915
7/10/1998,Small Soldiers,40000000,55143823,71743823,31743823,0.793596
7/31/1997,Spawn,40000000,54979992,87949859,47949859,1.19875
11/26/2014,Horrible Bosses 2,40000000,54445357,105945357,65945357,1.64863
1/25/2002,The Count of Monte Cristo,40000000,54228104,75389090,35389090,0.884727
10/20/2006,The Prestige,40000000,53089891,104407366,64407366,1.61018
6/16/2006,The Lake House,40000000,52330111,114830111,74830111,1.87075
7/9/2010,Predators,40000000,52000688,127234389,87234389,2.18086
8/15/2012,The Odd Life of Timothy Green,40000000,51853450,55249159,15249159,0.381229
7/31/1987,The Living Daylights,40000000,51185000,191200000,151200000,3.78
12/8/2006,Apocalypto,40000000,50866635,121032272,81032272,2.02581
2/14/2007,Music and Lyrics,40000000,50572589,146196885,106196885,2.65492
6/18/1986,Legal Eagles,40000000,49851591,49851591,9851591,0.24629
3/12/2004,Secret Window,40000000,47958031,92110539,52110539,1.30276
8/12/2005,The Skeleton Key,40000000,47907715,92256918,52256918,1.30642
6/18/2014,Jersey Boys,40000000,47047013,65282732,25282732,0.632068
5/2/2008,Made of Honor,40000000,46012734,106548738,66548738,1.66372
11/21/1997,The Rainmaker,40000000,45916769,45916769,5916769,0.147919
2/7/1992,Medicine Man,40000000,44948240,44948240,4948240,0.123706
12/12/1997,Amistad,40000000,44212592,58250151,18250151,0.456254
5/28/2014,A Million Ways to Die in The West,40000000,42720965,86778557,46778557,1.16946
8/12/2011,Final Destination 5,40000000,42587643,155011165,115011165,2.87528
11/9/2018,Widows,40000000,42402632,75984700,35984700,0.899617
4/8/2005,Fever Pitch,40000000,42071069,50071069,10071069,0.251777
12/25/2007,Aliens vs. Predator - Requiem,40000000,41797066,128884494,88884494,2.22211
12/25/2007,The Water Horse: Legend of the Deep,40000000,40412817,103429755,63429755,1.58574
7/16/2014,Sex Tape,40000000,38543473,126069509,86069509,2.15174
4/15/2011,Scream 4,40000000,38180928,95989590,55989590,1.39974
12/21/1994,Ri¢hie Ri¢h,40000000,38087756,38087756,-1912244,-0.0478061
8/11/2000,Autumn in New York,40000000,37752931,90717684,50717684,1.26794
3/18/2011,Paul,40000000,37412945,101162106,61162106,1.52905
12/19/2012,The Guilt Trip,40000000,37134215,41294674,1294674,0.0323669
8/26/2011,Colombiana,40000000,36665854,72295262,32295262,0.807382
2/26/1999,8MM,40000000,36443442,96398826,56398826,1.40997
1/11/2018,The Commuter,40000000,36343858,118509836,78509836,1.96275
2/18/2000,Hanging Up,40000000,36037909,51867723,11867723,0.296693
3/1/1991,The Doors,40000000,34416893,34420595,-5579405,-0.139485
8/20/1999,Mickey Blue Eyes,40000000,33864342,53864342,13864342,0.346609
8/1/2018,The Spy Who Dumped Me,40000000,33562069,77303614,37303614,0.93259
10/20/2000,Pay it Forward,40000000,33508922,55696705,15696705,0.392418
4/8/2011,Arthur,40000000,33035397,47787943,7787943,0.194699
3/21/2008,Drillbit Taylor,40000000,32862104,49686263,9686263,0.242157
12/21/2016,Patriots Day,40000000,31886361,52837989,12837989,0.32095
12/25/2011,Extremely Loud and Incredibly Close,40000000,31847881,55247881,15247881,0.381197
7/1/1994,The Shadow,40000000,31835600,31835600,-8164400,-0.20411
11/26/2008,Transporter 3,40000000,31715062,112930957,72930957,1.82327
11/10/2010,Morning Glory,40000000,31011732,59795070,19795070,0.494877
11/9/2005,Get Rich or Die Tryin',40000000,30981850,46666955,6666955,0.166674
5/1/2019,Long Shot,40000000,30316271,53624424,13624424,0.340611
8/25/2000,The Art of War,40000000,30199105,40390931,390931,0.00977327
12/25/2013,Grudge Match,40000000,29817991,69817991,29817991,0.74545
8/11/2000,Bless the Child,40000000,29374178,40435694,435694,0.0108924
11/23/2005,Rent,40000000,29077547,31670620,-8329380,-0.208234
4/2/1999,The Out-of-Towners,40000000,28544120,28544120,-11455880,-0.286397
8/11/2017,The Nut Job 2: Nutty by Nature,40000000,28370522,57438389,17438389,0.43596
8/23/1996,The Island of Dr. Moreau,40000000,27682712,27682712,-12317288,-0.307932
9/7/2001,The Musketeer,40000000,27053815,27053815,-12946185,-0.323655
12/23/2016,Resident Evil: The Final Chapter,40000000,26844692,314101190,274101190,6.85253
2/29/2008,The Other Boleyn Girl,40000000,26814957,78269970,38269970,0.956749
6/30/2017,The House,40000000,25584504,31192425,-8807575,-0.220189
2/16/2001,Sweet November,40000000,25288103,65754228,25754228,0.643856
4/5/2007,The Reaping,40000000,25126214,62226214,22226214,0.555655
1/7/2011,Season of the Witch,40000000,24827228,91126600,51126600,1.27816
6/3/1994,Renaissance Man,40000000,24172899,24172899,-15827101,-0.395678
5/15/1998,Quest for Camelot,40000000,22772500,38172500,-1827500,-0.0456875
9/6/2002,City by the Sea,40000000,22433915,22505932,-17494068,-0.437352
1/15/1999,At First Sight,40000000,22365133,22365133,-17634867,-0.440872
8/25/2016,Mechanic: Resurrection,40000000,21218403,125729635,85729635,2.14324
1/16/2004,Torque,40000000,21176322,46176322,6176322,0.154408
10/23/2009,Fantastic Mr. Fox,40000000,21002919,47001091,7001091,0.175027
8/24/2018,The Happytime Murders,40000000,20706452,27506412,-12493588,-0.31234
1/6/1995,Showgirls,40000000,20350754,37750754,-2249246,-0.0562312
2/16/1996,City Hall,40000000,20278055,20278055,-19721945,-0.493049
2/3/2012,Big Miracle,40000000,20157300,25268680,-14731320,-0.368283
10/11/2012,The Impossible,40000000,19019882,169590606,129590606,3.23977
3/9/2012,A Thousand Words,40000000,18450127,20790486,-19209514,-0.480238
7/28/2017,Detroit,40000000,16790139,26033563,-13966437,-0.349161
10/20/2006,Marie Antoinette,40000000,15962471,60862471,20862471,0.521562
10/19/2018,Hunter Killer,40000000,15767460,29312121,-10687879,-0.267197
10/6/2000,Get Carter,40000000,14967182,19417182,-20582818,-0.51457
4/21/1995,Kiss of Death,40000000,14942422,14942422,-25057578,-0.626439
10/20/2016,Keeping Up with the Joneses,40000000,14904426,28804426,-11195574,-0.279889
4/26/2002,Life or Something Like It,40000000,14448589,14448589,-25551411,-0.638785
5/15/1987,Ishtar,40000000,14375181,14375181,-25624819,-0.64062
2/28/1992,Memoirs of an Invisible Man,40000000,14358033,14358033,-25641967,-0.641049
10/23/2009,Amelia,40000000,14279575,19756077,-20243923,-0.506098
10/23/2009,Cirque du Freak: The Vampire's Assistant,40000000,14046595,39753957,-246043,-0.00615107
5/7/2004,New York Minute,40000000,14018364,21156715,-18843285,-0.471082
3/12/1999,The Deep End of the Ocean,40000000,13508635,13508635,-26491365,-0.662284
11/5/2004,Alfie,40000000,13395939,35195939,-4804061,-0.120102
8/30/2002,FearDotCom,40000000,13208023,13289290,-26710710,-0.667768
11/7/2008,Soul Men,40000000,12082391,12345883,-27654117,-0.691353
2/19/2015,The Gunman,40000000,10664749,24478613,-15521387,-0.388035
8/20/1999,Universal Soldier II: The Return,40000000,10447421,10717421,-29282579,-0.732064
9/25/2009,Pandorum,40000000,10330853,17033431,-22966569,-0.574164
9/26/2003,Duplex,40000000,9652000,10070651,-29929349,-0.748234
8/16/2013,Paranoia,40000000,7388654,16340767,-23659233,-0.591481
8/1/1980,Raise the Titanic,40000000,7000000,7000000,-33000000,-0.825
7/9/2015,Baahubali: The Beginning,40000000,6738000,26736665,-13263335,-0.331583
3/2/2018,The Hurricane Heist,40000000,6115824,33222314,-6777686,-0.169442
1/4/2002,Impostor,40000000,6114237,7974607,-32025393,-0.800635
11/25/2015,Victor Frankenstein,40000000,5775076,31124367,-8875633,-0.221891
9/12/2019,The Goldfinch,40000000,5332621,9430149,-30569851,-0.764246
11/27/2002,Extreme Ops,40000000,4835968,12624471,-27375529,-0.684388
4/6/2001,Just Visiting,40000000,4777007,16172200,-23827800,-0.595695
8/1/2013,Snowpiercer,40000000,4563029,86808205,46808205,1.17021
4/12/2007,Sunshine,40000000,3688560,32030610,-7969390,-0.199235
3/11/1994,The Hudsucker Proxy,40000000,2816518,14938149,-25061851,-0.626546
11/9/2016,Billy Lynn’s Long Halftime Walk,40000000,1738477,30230402,-9769598,-0.24424
7/1/1986,Pirates,40000000,1641825,6341825,-33658175,-0.841454
12/12/2008,Delgo,40000000,915840,915840,-39084160,-0.977104
9/7/2007,The Hunting Party,40000000,876671,7729552,-32270448,-0.806761
11/26/2021,Licorice Pizza,40000000,859423,859423,-39140577,-0.978514
10/13/2006,Alex Rider: Operation Stormbreaker,40000000,659210,20722450,-19277550,-0.481939
11/20/2009,Red Cliff,40000000,627047,119627047,79627047,1.99068
9/24/2004,The Last Shot,40000000,463730,463730,-39536270,-0.988407
3/16/2007,Nomad,40000000,79123,79123,-39920877,-0.998022
4/16/2013,Un monstre à Paris,40000000,0,27000381,-12999619,-0.32499
9/28/2012,Solomon Kane,40000000,0,22024849,-17975151,-0.449379
11/9/2018,Kursk,40000000,0,5578259,-34421741,-0.860544
9/23/2016,USS Indianapolis: Men of Courage,40000000,0,1663785,-38336215,-0.958405
4/10/2015,Dragon Nest Warriors' Dawn,40000000,0,734423,-39265577,-0.981639
11/8/2019,Klaus,40000000,0,0,-40000000,-1
8/25/2017,Death Note,40000000,0,0,-40000000,-1
,Down Under Cover,40000000,0,0,-40000000,-1
2/7/2020,Timmy Failure: Mistakes Were Made,40000000,0,0,-40000000,-1
12/16/2022,Heaven and Hell,40000000,0,0,-40000000,-1
8/14/2009,The Time Traveler’s Wife,39000000,63414846,102332135,63332135,1.6239
6/17/1983,Superman III,39000000,59950623,80200000,41200000,1.05641
2/2/2007,Because I Said So,39000000,42674040,69538833,30538833,0.783047
10/4/2012,Frankenweenie,39000000,35287788,81150788,42150788,1.08079
3/29/1996,Sgt. Bilko,39000000,30356589,37956589,-1043411,-0.0267541
9/30/2005,Serenity,39000000,25514517,40319440,1319440,0.0338318
9/7/2007,Shoot 'Em Up,39000000,12796824,26796824,-12203176,-0.312902
2/20/2004,Against the Ropes,39000000,5881504,6429865,-32570135,-0.835132
1/8/2013,Yi dai zong shi,38600000,6594959,57987299,19387299,0.502262
6/22/2001,The Fast and the Furious,38000000,144512310,206458372,168458372,4.43312
9/27/2002,Sweet Home Alabama,38000000,127214072,182365114,144365114,3.79908
7/24/2009,The Ugly Truth,38000000,88915214,205298907,167298907,4.4026
8/7/2002,Spy Kids 2: The Island of Lost Dreams,38000000,85846296,119721296,81721296,2.15056
11/18/1994,Star Trek: Generations,38000000,75671262,120000000,82000000,2.15789
6/2/2017,Captain Underpants: The First Epic Movie,38000000,73921000,126422949,88422949,2.32692
4/10/2015,Paul Blart: Mall Cop 2,38000000,71091594,107650646,69650646,1.83291
12/19/1997,Mouse Hunt,38000000,61894591,61894591,23894591,0.628805
12/21/2016,Why Him?,38000000,60323786,117425156,79425156,2.09014
4/22/2011,Water for Elephants,38000000,58709717,116809717,78809717,2.07394
10/8/2010,Life as We Know It,38000000,53374681,105887837,67887837,1.78652
12/29/1999,The Hurricane,38000000,50699241,73956241,35956241,0.946217
9/5/2013,Riddick,38000000,42025135,94763758,56763758,1.49378
3/23/2001,Heartbreakers,38000000,40334024,57753825,19753825,0.519837
5/24/2002,Enough,38000000,39177215,50970660,12970660,0.341333
1/14/2016,The 5th Wave,38000000,34912982,111336398,73336398,1.92991
2/6/2009,Push,38000000,31811527,49678401,11678401,0.307326
9/13/2013,Rush,38000000,26947624,98230839,60230839,1.58502
5/18/2001,Angel Eyes,38000000,24044532,29544532,-8455468,-0.222512
12/21/2001,Joe Somebody,38000000,22770864,24515990,-13484010,-0.354842
11/3/2018,Overlord,38000000,21704844,39178189,1178189,0.031005
8/28/2020,The War with Grandpa,38000000,21277892,40229485,2229485,0.0586707
3/10/2000,The Ninth Gate,38000000,18653746,58394308,20394308,0.536692
10/20/2017,Only the Brave,38000000,18340051,24555177,-13444823,-0.353811
9/27/1996,Extreme Measures,38000000,17378193,17378193,-20621807,-0.542679
10/14/2011,The Thing,38000000,16999934,27573078,-10426922,-0.274393
9/7/2001,Rock Star,38000000,16991902,19317765,-18682235,-0.491638
12/25/2020,News of the World,38000000,12668325,12668325,-25331675,-0.666623
8/9/2019,The Kitchen,38000000,12180032,15779653,-22220347,-0.584746
2/2/1996,White Squall,38000000,10229300,10229300,-27770700,-0.730808
10/10/2008,City of Ember,38000000,7873007,17831558,-20168442,-0.530748
10/31/1997,Switchback,38000000,6504442,6504442,-31495558,-0.82883
9/21/2018,The Sisters Brothers,38000000,3143056,14636067,-23363933,-0.61484
11/30/2001,Texas Rangers,38000000,623374,623374,-37376626,-0.983595
8/26/2008,Virgin Territory,38000000,0,5473041,-32526959,-0.855973
1/10/2019,The Upside,37500000,108235497,125818440,88318440,2.35516
5/17/2012,What to Expect When You're Expecting,37500000,41152203,88473016,50973016,1.35928
9/14/2012,The Master,37500000,16247159,50879131,13379131,0.356777
10/10/2008,The Express,37500000,9793406,9813309,-27686691,-0.738312
11/21/2008,Twilight,37000000,192769854,402280159,365280159,9.87244
8/7/2013,We’re the Millers,37000000,150394119,267816276,230816276,6.23828
11/25/2015,Creed,37000000,109767581,173567581,136567581,3.69102
9/17/2010,The Town,37000000,92186262,152566881,115566881,3.12343
9/23/2011,Dolphin Tale,37000000,72286779,96068724,59068724,1.59645
2/23/2018,Game Night,37000000,69179066,117378084,80378084,2.17238
9/12/2008,Burn After Reading,37000000,60355347,168167798,131167798,3.54508
4/23/2004,13 Going On 30,37000000,57139723,97658712,60658712,1.63942
3/29/2013,Tyler Perry’s Temptation,37000000,51975354,53143144,16143144,0.436301
4/4/2008,Nim's Island,37000000,48006762,101857425,64857425,1.7529
2/8/2016,How to be Single,37000000,46843513,100003780,63003780,1.7028
2/26/2010,Cop Out,37000000,44875481,55909910,18909910,0.511079
1/28/2011,The Rite,37000000,33047633,97143987,60143987,1.62551
7/18/2008,Space Chimps,37000000,30105968,67029956,30029956,0.81162
12/17/1999,Magnolia,37000000,22450975,48446802,11446802,0.309373
5/27/2015,Aloha,37000000,21052030,25387091,-11612909,-0.313862
,Obitaemyy ostrov,36500000,0,15000000,-21500000,-0.589041
10/5/2018,A Star is Born,36000000,215288866,431870523,395870523,10.9964
2/11/2011,Gnomeo and Juliet,36000000,99967670,193737977,157737977,4.38161
2/15/2002,John Q.,36000000,71026631,102226631,66226631,1.83963
9/17/1999,Blue Streak,36000000,68208190,117448157,81448157,2.26245
10/7/1983,Never Say Never Again,36000000,55500000,160000000,124000000,3.44444
3/26/2010,Hot Tub Time Machine,36000000,50269859,65967750,29967750,0.832438
5/2/1997,Breakdown,36000000,50159144,50159144,14159144,0.39331
9/12/2014,Dolphin Tale 2,36000000,42024533,57824533,21824533,0.606237
12/16/2016,Collateral Beauty,36000000,31016021,85309093,49309093,1.3697
4/4/2003,A Man Apart,36000000,26500000,43797731,7797731,0.216604
2/25/2000,Reindeer Games,36000000,23360779,23360779,-12639221,-0.351089
12/24/1999,Snow Falling on Cedars,36000000,14378353,14378353,-21621647,-0.600601
12/20/1996,Ghosts of Mississippi,36000000,13052741,13052741,-22947259,-0.637424
10/24/1997,Gattaca,36000000,12532777,12532777,-23467223,-0.651867
1/28/2000,Isn't She Great,36000000,2954405,2954405,-33045595,-0.917933
12/24/2015,Yip Man 3,36000000,2679437,157300954,121300954,3.36947
5/6/2011,There Be Dragons,36000000,1069334,4020990,-31979010,-0.888306
9/3/2015,Queen of the Desert,36000000,0,1578543,-34421457,-0.956152
3/28/2003,Head of State,35200000,37788228,38283765,3083765,0.087607
8/31/2017,It,35000000,328828874,701083042,666083042,19.0309
6/5/2009,The Hangover,35000000,277322503,465487583,430487583,12.2996
11/20/2009,The Blind Side,35000000,255959475,305705794,270705794,7.73445
6/23/1989,Batman,35000000,251188924,411348924,376348924,10.7528
6/10/1999,Austin Powers: The Spy Who Shagged Me,35000000,206040085,312383487,277383487,7.92524
12/22/2010,True Grit,35000000,171243005,252276928,217276928,6.20791
5/15/1992,Lethal Weapon 3,35000000,144731527,319700000,284700000,8.13429
9/18/1998,Rush Hour,35000000,141186864,245300000,210300000,6.00857
2/7/2013,Identity Thief,35000000,134506920,175361578,140361578,4.01033
6/30/2006,The Devil Wears Prada,35000000,124740460,326073155,291073155,8.31638
7/8/2011,Horrible Bosses,35000000,117538559,212417601,177417601,5.06907
3/30/2001,Spy Kids,35000000,112692062,197692062,162692062,4.64834
7/17/2015,Trainwreck,35000000,110212700,141123897,106123897,3.03211
11/29/2013,Saving Mr. Banks,35000000,83299761,114962525,79962525,2.28464
12/7/1979,Star Trek: The Motion Picture,35000000,82258456,139000000,104000000,2.97143
3/28/2008,21,35000000,81159365,159846429,124846429,3.56704
5/9/2008,What Happens in Vegas...,35000000,80277646,218535708,183535708,5.24388
11/15/1991,Cape Fear,35000000,79091969,182291969,147291969,4.20834
11/15/1996,The English Patient,35000000,78716374,231710008,196710008,5.62029
1/16/2009,Hotel for Dogs,35000000,73178547,122357172,87357172,2.49592
3/25/2005,Guess Who,35000000,68915888,102115888,67115888,1.9176
12/20/2012,This is 40,35000000,67544505,90221182,55221182,1.57775
9/19/1997,L.A. Confidential,35000000,64604977,126204977,91204977,2.60586
7/29/2005,Sky High,35000000,63939454,83109359,48109359,1.37455
9/19/1997,In & Out,35000000,63826569,83226569,48226569,1.3779
4/30/2010,A Nightmare on Elm Street,35000000,63075011,117729621,82729621,2.3637
8/18/2000,The Cell,35000000,61280963,85911226,50911226,1.45461
7/7/1995,Species,35000000,60054449,113354449,78354449,2.2387
4/7/2006,The Benchwarmers,35000000,59843754,65063726,30063726,0.858964
10/8/2010,Secretariat,35000000,59699513,60376247,25376247,0.725036
3/13/1998,The Man in the Iron Mask,35000000,56968169,56968169,21968169,0.627662
7/22/2011,Friends with Benefits,35000000,55802754,146595891,111595891,3.18845
5/5/2016,Neighbors 2: Sorority Rising,35000000,55340730,108757621,73757621,2.10736
3/23/2007,TMNT,35000000,54149098,96096018,61096018,1.7456
10/24/2003,Radio,35000000,52333738,53293628,18293628,0.522675
6/25/2018,Sicario: Day of the Soldado,35000000,50065850,76346094,41346094,1.18132
11/25/2009,Old Dogs,35000000,49492060,95104304,60104304,1.71727
11/18/1992,Malcolm X,35000000,48169910,48169910,13169910,0.376283
5/20/2015,Poltergeist,35000000,47425125,95713069,60713069,1.73466
10/10/2018,Goosebumps 2: Haunted Halloween,35000000,46697321,93291478,58291478,1.66547
1/16/2018,12 Strong,35000000,45819713,71118378,36118378,1.03195
1/23/2009,Underworld 3: Rise of the Lycans,35000000,45802315,89102315,54102315,1.54578
7/29/2005,Must Love Dogs,35000000,43894863,58405313,23405313,0.668723
7/3/2007,License to Wed,35000000,43799818,70187088,35187088,1.00535
2/28/1997,Donnie Brasco,35000000,41954997,65303052,30303052,0.865801
10/17/2008,Max Payne,35000000,40689393,87775050,52775050,1.50786
3/15/2002,Resident Evil,35000000,40119709,103787401,68787401,1.96535
3/26/2004,The Ladykillers,35000000,39692139,77392139,42392139,1.2112
5/6/2011,Something Borrowed,35000000,39046489,65084116,30084116,0.859546
12/1/2006,The Nativity Story,35000000,37629831,46309644,11309644,0.323133
10/28/2011,In Time,35000000,37553932,165103952,130103952,3.71726
4/23/2010,The Back-up Plan,35000000,37490007,75281179,40281179,1.15089
11/9/2011,J. Edgar,35000000,37306030,84606030,49606030,1.41732
11/17/2000,Bounce,35000000,36805288,53425292,18425292,0.526437
8/17/2018,Mile 22,35000000,36108758,66295121,31295121,0.894146
5/8/2015,Hot Pursuit,35000000,34580201,45671512,10671512,0.3049
12/24/2015,Concussion,35000000,34531832,50363790,15363790,0.438965
9/29/2017,The Foreigner,35000000,34393507,145374099,110374099,3.15355
12/3/2004,Closer,35000000,33987757,116148537,81148537,2.31853
12/23/1994,Street Fighter,35000000,33423000,99423000,64423000,1.84066
11/21/2001,Black Knight,35000000,33422806,33422806,-1577194,-0.0450627
7/22/2005,The Bad News Bears,35000000,32868349,33500620,-1499380,-0.0428394
12/27/2002,The Pianist,35000000,32519322,111854182,76854182,2.19583
5/6/2005,House of Wax,35000000,32064800,70064800,35064800,1.00185
10/19/2001,From Hell,35000000,31598308,68712365,33712365,0.96321
6/1/2018,Adrift,35000000,31445011,57897191,22897191,0.654205
8/15/2008,Mirrors,35000000,30691439,77220596,42220596,1.2063
11/25/2016,Underworld: Blood Wars,35000000,30353973,81209222,46209222,1.32026
2/22/2002,Queen of the Damned,35000000,30307804,30307804,-4692196,-0.134063
8/20/2010,Nanny McPhee and the Big Bang,35000000,29197642,97799865,62799865,1.79428
1/25/2008,Untraceable,35000000,28687835,52649951,17649951,0.504284
11/21/1990,Predator 2,35000000,28317513,54768418,19768418,0.564812
9/23/2011,Abduction,35000000,28087155,86648359,51648359,1.47567
12/5/1980,Flash Gordon,35000000,27107960,27181521,-7818479,-0.223385
3/28/2008,Superhero Movie,35000000,26638520,73026302,38026302,1.08647
2/12/1999,Blast from the Past,35000000,26613620,26613620,-8386380,-0.239611
10/17/2012,Alex Cross,35000000,25888412,35426759,426759,0.0121931
3/26/2004,Jersey Girl,35000000,25266129,37066129,2066129,0.0590323
11/21/1997,Midnight in the Garden of Good and Evil,35000000,25078937,25078937,-9921063,-0.283459
9/6/2016,Bridget Jones’s Baby,35000000,24139805,207298383,172298383,4.92281
11/9/2001,Heist,35000000,23483357,28906817,-6093183,-0.174091
12/25/1992,Hoffa,35000000,23365858,28391473,-6608527,-0.188815
3/4/2016,Whiskey Tango Foxtrot,35000000,23083334,25350747,-9649253,-0.275693
4/9/2004,Ella Enchanted,35000000,22913677,24200318,-10799682,-0.308562
8/19/2015,Hitman: Agent 47,35000000,22467450,82182803,47182803,1.34808
12/25/2017,Phantom Thread,35000000,21198205,47896721,12896721,0.368478
7/25/2008,The X-Files: I Want to Believe,35000000,20982478,68170792,33170792,0.947737
8/23/2012,Premium Rush,35000000,20275446,31393201,-3606799,-0.103051
1/18/2013,Broken City,35000000,19701164,37114977,2114977,0.0604279
8/19/2005,Valiant,35000000,19478106,64188387,29188387,0.833954
2/23/2000,Wonder Boys,35000000,19389454,33422485,-1577515,-0.0450719
2/25/2005,Cursed,35000000,19294901,25114901,-9885099,-0.282431
12/21/2007,Walk Hard: The Dewey Cox Story,35000000,18317151,20606053,-14393947,-0.411256
9/20/2002,The Four Feathers,35000000,18306166,29882645,-5117355,-0.14621
4/30/2010,Furry Vengeance,35000000,17630465,39340177,4340177,0.124005
1/24/2013,Parker,35000000,17616641,48543388,13543388,0.386954
9/17/2004,Wimbledon,35000000,16862585,41666476,6666476,0.190471
9/15/2000,Bait,35000000,15325127,15471969,-19528031,-0.557944
12/8/2000,Dungeons and Dragons,35000000,15185241,33771965,-1228035,-0.0350867
11/9/2007,Lions for Lambs,35000000,14998070,63211088,28211088,0.806031
1/18/1991,Flight of the Intruder,35000000,14471440,14471440,-20528560,-0.58653
5/27/2011,The Tree of Life,35000000,13305665,61721826,26721826,0.763481
8/17/2001,American Outlaws,35000000,13264986,13601109,-21398891,-0.611397
12/7/2012,Playing for Keeps,35000000,13103272,27805632,-7194368,-0.205553
8/11/2006,Zoom,35000000,11989328,12506188,-22493812,-0.64268
12/25/2001,The Shipping News,35000000,11405825,24405825,-10594175,-0.302691
12/18/2009,The Young Victoria,35000000,11001272,31878891,-3121109,-0.0891745
3/28/2014,Sabotage,35000000,10508518,18376443,-16623557,-0.474959
9/4/1998,Knock Off,35000000,10319915,10319915,-24680085,-0.705145
9/11/2009,Whiteout,35000000,10275638,12254746,-22745254,-0.649864
3/5/2015,Unfinished Business,35000000,10219501,13214051,-21785949,-0.622456
9/30/2015,The Walk,35000000,10161183,61492104,26492104,0.756917
11/22/2006,The Fountain,35000000,10144010,15461638,-19538362,-0.558239
11/28/2013,Mandela: Long Walk to Freedom,35000000,8323085,29890402,-5109598,-0.145989
12/5/2008,Punisher: War Zone,35000000,8050977,10157534,-24842466,-0.709785
9/5/2003,The Order,35000000,7659747,11559747,-23440253,-0.669722
11/10/2006,A Good Year,35000000,7459300,42064105,7064105,0.201832
2/24/2016,The Brothers Grimsby,35000000,6864016,28720470,-6279530,-0.179415
10/11/2017,The Snowman,35000000,6670765,43164679,8164679,0.233277
11/6/2002,Femme Fatale,35000000,6630252,16830252,-18169748,-0.519136
5/2/1997,Warriors of Virtue,35000000,6448817,6448817,-28551183,-0.815748
9/26/2003,Luther,35000000,5781086,32717063,-2282937,-0.0652268
1/28/2011,Biutiful,35000000,5101237,24687524,-10312476,-0.294642
2/21/1992,Radio Flyer,35000000,4651977,4651977,-30348023,-0.867086
4/16/1993,Bound by Honor,35000000,4496583,4496583,-30503417,-0.871526
4/22/2016,A Hologram for the King,35000000,4212494,11846010,-23153990,-0.661543
2/28/1997,Smilla's Sense of Snow,35000000,2221994,2221994,-32778006,-0.936514
10/3/1986,Playing for Keeps,35000000,2000000,2000000,-33000000,-0.942857
1/1/1980,Lion of the Desert,35000000,1500000,1502136,-33497864,-0.957082
4/19/1996,Le hussard sur le toit,35000000,1320043,1320043,-33679957,-0.962284
11/24/1999,Ride With the Devil,35000000,630779,630779,-34369221,-0.981978
9/14/2012,Stolen,35000000,289773,17967746,-17032254,-0.486636
10/14/2011,Trespass,35000000,16816,786532,-34213468,-0.977528
9/22/2006,Bandidas,35000000,0,19282590,-15717410,-0.449069
10/2/2020,The Trial of the Chicago 7,35000000,0,115709,-34884291,-0.996694
3/13/2015,The Lovers,35000000,0,53899,-34946101,-0.99846
,Black Water Transit,35000000,0,0,-35000000,-1
12/25/2011,The Darkest Hour,34800000,21443494,62831715,28031715,0.805509
6/28/2017,Baby Driver,34000000,107825862,228104185,194104185,5.70895
9/11/2014,The Maze Runner,34000000,102427862,348319861,314319861,9.2447
4/9/2015,The Longest Ride,34000000,37446117,63802928,29802928,0.876557
9/17/1993,The Age of Innocence,34000000,32014993,32014993,-1985007,-0.0583826
8/14/2009,Gake no ue no Ponyo,34000000,15090399,205162666,171162666,5.0342
8/3/2018,The Darkest Minds,34000000,12695691,38361428,4361428,0.128277
9/1/1999,Chill Factor,34000000,11263966,11263966,-22736034,-0.668707
8/27/1999,The Astronaut's Wife,34000000,10672566,10672566,-23327434,-0.686101
5/5/2000,I Dreamed of Africa,34000000,6543194,14291999,-19708001,-0.579647
5/22/2014,Thunder and the House of Magic,34000000,4091,62582520,28582520,0.840662
7/31/2020,Greenland,34000000,0,40610111,6610111,0.194415
12/4/1981,Reds,33500000,50000000,50000000,16500000,0.492537
12/11/1992,A Few Good Men,33000000,141340178,236500000,203500000,6.16667
6/2/2000,Big Momma's House,33000000,117559438,173559438,140559438,4.25938
3/16/2001,Exit Wounds,33000000,51758599,79958599,46958599,1.42299
7/7/2016,Mike and Dave Need Wedding Dates,33000000,46009673,75898100,42898100,1.29994
7/26/2012,Step Up Revolution,33000000,35074677,165552290,132552290,4.01674
8/18/2006,Snakes on a Plane,33000000,34020814,62020814,29020814,0.879419
4/16/2004,The Punisher,33000000,33664370,54533774,21533774,0.652539
9/8/2000,The Watcher,33000000,28946615,47267829,14267829,0.432358
11/22/2019,21 Bridges,33000000,28539757,42663460,9663460,0.292832
7/16/2020,Unhinged,33000000,20831465,37321536,4321536,0.130956
4/27/2012,Safe,33000000,17142080,41495213,8495213,0.257431
3/14/2008,Doomsday,33000000,11008770,21621188,-11378812,-0.344812
4/23/1999,Pushing Tin,33000000,8408835,8408835,-24591165,-0.745187
5/12/2006,Goal! The Dream Begins,33000000,4283255,27610873,-5389127,-0.163307
7/9/2015,The Young and Prodigious T.S. Spivet,33000000,176847,357687,-32642313,-0.989161
10/30/2015,Freaks of Nature,33000000,70958,70958,-32929042,-0.99785
5/25/1983,Star Wars Ep. VI: Return of the Jedi,32500000,309205079,475106177,442606177,13.6187
5/13/2011,Bridesmaids,32500000,169211718,289632023,257132023,7.91175
12/10/2008,The Reader,32500000,34194407,112964875,80464875,2.47584
4/25/2013,The Big Wedding,32500000,21819348,48425971,15925971,0.49003
2/24/2012,Wanderlust,32500000,17288155,24159934,-8340066,-0.256617
11/7/2003,Elf,32000000,175531840,222369732,190369732,5.94905
7/5/1996,Phenomenon,32000000,104636382,152036382,120036382,3.75114
6/12/2013,This is the End,32000000,101470202,126539117,94539117,2.95435
1/18/2002,Snow Dogs,32000000,81150692,116898028,84898028,2.65306
6/16/2006,Nacho Libre,32000000,80197993,99296462,67296462,2.10301
11/23/1988,Scrooged,32000000,59450353,59450796,27450796,0.857837
8/27/2010,Takers,32000000,57744720,70587268,38587268,1.20585
4/1/2011,Source Code,32000000,54712227,140428499,108428499,3.38839
9/10/1999,Stigmata,32000000,50041732,89441732,57441732,1.79505
11/10/2000,Men of Honor,32000000,48814909,82339483,50339483,1.57311
4/20/2018,I Feel Pretty,32000000,48795601,91444095,59444095,1.85763
9/2/2005,The Transporter 2,32000000,43095856,88978458,56978458,1.78058
2/18/2011,Big Mommas: Like Father Like Son,32000000,37915414,82332450,50332450,1.57289
1/15/1993,Alive,32000000,36299670,36299670,4299670,0.134365
2/23/2007,The Number 23,32000000,35193167,77593167,45593167,1.42479
12/14/1979,1941,32000000,34175000,94875000,62875000,1.96484
10/21/2005,Dreamer: Inspired by a True Story,32000000,33022286,39498360,7498360,0.234324
12/13/2019,Bombshell,32000000,31762808,61404394,29404394,0.918887
9/23/2005,A History of Violence,32000000,31493782,61477797,29477797,0.921181
3/14/2013,The Incredible Burt Wonderstone,32000000,22537881,27392609,-4607391,-0.143981
2/10/1995,The Quick and the Dead,32000000,18552460,18552460,-13447540,-0.420236
4/30/2004,Laws of Attraction,32000000,17848322,29939591,-2060409,-0.0643878
9/27/2018,Bad Times at the El Royale,32000000,17839115,31178942,-821058,-0.0256581
9/3/2010,Going the Distance,32000000,17804299,43603990,11603990,0.362625
10/22/1999,Bringing Out The Dead,32000000,16640210,16640210,-15359790,-0.479993
3/19/2010,Repo Men,32000000,13942007,18195238,-13804762,-0.431399
9/14/2007,Dragon Wars: D-War,32000000,10977721,79915361,47915361,1.49736
9/6/1996,Bogus,32000000,4357406,4357406,-27642594,-0.863831
3/26/1997,Cats Don't Dance,32000000,3588602,3588602,-28411398,-0.887856
12/8/1999,Cradle Will Rock,32000000,2899970,2899970,-29100030,-0.909376
12/15/2006,The Good German,32000000,1308696,6678033,-25321967,-0.791311
,George and the Dragon,32000000,0,0,-32000000,-1
8/15/1979,Apocalypse Now,31500000,83471511,85908699,54408699,1.72726
8/21/2015,Criminal,31500000,14708696,38771262,7271262,0.230834
3/2/2018,La ch'tite famille,31400000,0,55613061,24213061,0.771117
4/12/2013,42,31000000,95020213,97470701,66470701,2.14422
11/2/2012,Flight,31000000,93772375,160558438,129558438,4.1793
12/29/1995,Mr. Holland’s Opus,31000000,82582604,106282604,75282604,2.42847
6/29/1979,Moonraker,31000000,70300000,210300000,179300000,5.78387
3/5/2014,The Grand Budapest Hotel,31000000,59076019,163503514,132503514,4.27431
7/29/2015,Vacation,31000000,58884188,102306500,71306500,2.30021
7/18/1990,Arachnophobia,31000000,53208180,53208180,22208180,0.716393
2/13/2019,Isn’t it Romantic,31000000,48791187,48791187,17791187,0.573909
4/28/2000,Frequency,31000000,44983704,68079671,37079671,1.19612
9/28/2001,Hearts in Atlantis,31000000,24185781,30885781,-114219,-0.00368448
1/22/2010,Extraordinary Measures,31000000,12482741,15826984,-15173016,-0.489452
8/25/2017,Birth of the Dragon,31000000,6901965,7220490,-23779510,-0.767081
10/20/1995,Get Shorty,30250000,72021008,115021008,84771008,2.80235
6/8/1984,Ghostbusters,30000000,242604185,295600371,265600371,8.85335
11/22/1995,Toy Story,30000000,192523233,365270951,335270951,11.1757
8/15/2018,Crazy Rich Asians,30000000,174532921,238099711,208099711,6.93666
12/27/2002,Chicago,30000000,170687518,306770545,276770545,9.22568
6/25/1999,Big Daddy,30000000,163479795,228641283,198641283,6.62138
8/10/2001,American Pie 2,30000000,145096820,286500000,256500000,8.55
2/9/2012,The Vow,30000000,125014030,197618160,167618160,5.58727
6/10/1994,Speed,30000000,121248145,283200000,253200000,8.44
3/2/1990,The Hunt for Red October,30000000,120709866,200500000,170500000,5.68333
8/16/2013,Lee Daniels' The Butler,30000000,116632095,177025498,147025498,4.90085
9/29/2000,Remember the Titans,30000000,115719751,136771683,106771683,3.55906
8/14/2009,District 9,30000000,115646235,212453431,182453431,6.08178
6/18/2004,Dodgeball: A True Underdog Story,30000000,114326736,167791704,137791704,4.59306
11/22/1991,The Addams Family,30000000,113502246,191502246,161502246,5.38341
11/10/1995,Ace Ventura: When Nature Calls,30000000,108360063,212400000,182400000,6.08
8/3/2001,The Princess Diaries,30000000,108244774,165334774,135334774,4.51116
3/5/1999,Analyze This,30000000,106885658,176885658,146885658,4.89619
9/20/1996,The First Wives Club,30000000,105489203,181489203,151489203,5.04964
12/15/2004,Million Dollar Baby,30000000,100492203,231928227,201928227,6.73094
9/22/1995,Se7en,30000000,100125643,328125643,298125643,9.93752
10/8/2003,Mystic River,30000000,90135191,156822020,126822020,4.2274
12/18/2015,Sisters,30000000,87044645,106030660,76030660,2.53436
11/10/1999,Pokemon: The First Movie,30000000,85744662,163644662,133644662,4.45482
11/19/2004,SpongeBob SquarePants: The Movie,30000000,85416609,142051255,112051255,3.73504
6/25/2004,The Notebook,30000000,81001787,115937163,85937163,2.86457
4/10/2009,Hannah Montana: The Movie,30000000,79576189,169173206,139173206,4.63911
1/18/2008,27 Dresses,30000000,76808654,160247805,130247805,4.34159
11/17/2000,Rugrats in Paris,30000000,76501438,103284813,73284813,2.44283
8/18/2017,The Hitman’s Bodyguard,30000000,75468583,183415183,153415183,5.11384
12/25/1991,The Prince of Tides,30000000,74787599,74787599,44787599,1.49292
8/12/2005,Four Brothers,30000000,74494381,92494381,62494381,2.08315
12/23/1994,Legends of the Fall,30000000,66502573,160502573,130502573,4.35009
9/27/2012,Looper,30000000,66486205,170466405,140466405,4.68221
1/31/2013,Warm Bodies,30000000,66380662,114834312,84834312,2.82781
12/13/2002,About Schmidt,30000000,65005217,107054484,77054484,2.56848
1/17/2014,The Nut Job,30000000,64251538,122529966,92529966,3.08433
2/16/2001,Down to Earth,30000000,64172251,71172251,41172251,1.37241
8/4/1995,Babe,30000000,63658910,246100000,216100000,7.20333
8/8/2012,Hope Springs,30000000,63536011,133085295,103085295,3.43618
4/18/2008,Forgetting Sarah Marshall,30000000,63172463,105475310,75475310,2.51584
10/8/2004,Friday Night Lights,30000000,61255921,61950770,31950770,1.06503
11/17/1989,Harlem Nights,30000000,60857262,95857262,65857262,2.19524
4/25/2008,Baby Mama,30000000,60494212,64170447,34170447,1.13901
5/29/1998,Hope Floats,30000000,60110313,81529000,51529000,1.71763
1/9/2009,Bride Wars,30000000,58715510,115150424,85150424,2.83835
8/20/2004,Without a Paddle,30000000,58156435,65121280,35121280,1.17071
5/20/2011,Midnight in Paris,30000000,56816662,162275213,132275213,4.40917
11/22/2017,Darkest Hour,30000000,56443120,150832086,120832086,4.02774
10/5/2005,Wallace & Gromit: The Curse of the Were-Rabbit,30000000,56068547,197593152,167593152,5.58644
12/21/2007,P.S. I Love You,30000000,53695808,155769678,125769678,4.19232
9/23/2005,Corpse Bride,30000000,53359111,114770654,84770654,2.82569
5/10/2018,Life of the Party,30000000,53059911,65859911,35859911,1.19533
5/14/2010,Letters to Juliet,30000000,53032453,82148538,52148538,1.73828
4/6/2001,Blow,30000000,52990775,83282296,53282296,1.77608
2/12/1999,Message in a Bottle,30000000,52880016,52880016,22880016,0.762667
7/22/2015,Southpaw,30000000,52421953,94156456,64156456,2.13855
6/9/1989,Star Trek V: The Final Frontier,30000000,52210049,70200000,40200000,1.34
7/27/2017,Atomic Blonde,30000000,51573925,98345423,68345423,2.27818
7/3/2002,Like Mike,30000000,51432423,62432423,32432423,1.08108
3/18/1994,Naked Gun 33 1/3: The Final Insult,30000000,51041856,51041856,21041856,0.701395
12/7/2007,Atonement,30000000,50980159,129779728,99779728,3.32599
5/24/1985,A View to a Kill,30000000,50327960,152627960,122627960,4.0876
2/5/1993,Sommersby,30000000,50081992,140081992,110081992,3.6694
1/7/2005,Racing Stripes,30000000,49772522,89809433,59809433,1.99365
9/17/2015,Sicario,30000000,46889293,84335703,54335703,1.81119
9/22/1989,Black Rain,30000000,45892212,133892212,103892212,3.46307
6/26/1987,Full Metal Jacket,30000000,45015999,45015999,15015999,0.500533
1/19/2018,Den of Thieves,30000000,44947622,80147166,50147166,1.67157
4/13/2012,The Three Stooges,30000000,44338224,54052249,24052249,0.801742
7/21/2000,Pokemon 2000,30000000,43746923,133946923,103946923,3.4649
10/24/2014,John Wick,30000000,43037835,76010510,46010510,1.53368
1/13/2006,Glory Road,30000000,42647449,42799060,12799060,0.426635
4/16/2015,The Age of Adaline,30000000,42629776,68984536,38984536,1.29948
8/6/2010,Step Up 3D,30000000,42400223,165889117,135889117,4.52964
5/29/2009,Drag Me To Hell,30000000,42100625,91388487,61388487,2.04628
4/13/2012,The Cabin in the Woods,30000000,42073277,70689968,40689968,1.35633
9/19/2003,Secondhand Lions,30000000,42070939,47902566,17902566,0.596752
11/10/2006,Stranger Than Fiction,30000000,40435190,53572822,23572822,0.785761
4/8/2011,Hanna,30000000,40259119,65343694,35343694,1.17812
8/16/2002,Blue Crush,30000000,40118420,51618420,21618420,0.720614
10/19/2007,30 Days of Night,30000000,39568996,80276156,50276156,1.67587
12/19/1986,Little Shop of Horrors,30000000,38747385,38747385,8747385,0.291579
9/15/2006,Gridiron Gang,30000000,38432823,41457834,11457834,0.381928
7/20/1988,Midnight Run,30000000,38413606,81613606,51613606,1.72045
1/25/2008,Meet the Spartans,30000000,38233676,84646831,54646831,1.82156
11/13/1987,The Running Man,30000000,38122000,38122000,8122000,0.270733
9/13/2013,The Family,30000000,36918811,80588942,50588942,1.6863
2/9/2018,The 15:17 to Paris,30000000,36276286,56096200,26096200,0.869873
11/21/1997,Mortal Kombat: Annihilation,30000000,35927406,51327406,21327406,0.710914
7/1/2011,Larry Crowne,30000000,35608245,61449135,31449135,1.0483
10/18/2013,Carrie,30000000,35266619,82409520,52409520,1.74698
11/7/2019,Last Christmas,30000000,35150750,123432533,93432533,3.11442
4/7/2006,Take the Lead,30000000,34742066,65390493,35390493,1.17968
3/2/2018,Death Wish,30000000,34017028,48575965,18575965,0.619199
11/24/2010,Love and Other Drugs,30000000,32367005,102716321,72716321,2.42388
6/3/2015,Entourage,30000000,32363404,46438538,16438538,0.547951
6/1/2001,What's the Worst That Could Happen?,30000000,32267774,38462071,8462071,0.282069
2/8/2013,Side Effects,30000000,32172757,66742138,36742138,1.22474
9/9/2009,9,30000000,31749894,48559999,18559999,0.618667
7/2/2014,Deliver Us from Evil,30000000,30577122,87956618,57956618,1.93189
8/1/2014,Get on Up,30000000,30569935,33339868,3339868,0.111329
12/22/2017,Molly’s Game,30000000,28780744,53296424,23296424,0.776547
4/27/2012,The Five-Year Engagement,30000000,28700285,61623819,31623819,1.05413
4/2/2004,The Prince & Me,30000000,28165882,30089110,89110,0.00297033
4/15/2011,Winnie the Pooh,30000000,26692846,50145607,20145607,0.67152
5/15/1998,Bulworth,30000000,26528684,29203383,-796617,-0.0265539
6/13/2003,Dumb and Dumberer: When Harry Met Lloyd,30000000,26214846,28986358,-1013642,-0.0337881
9/14/2018,White Boy Rick,30000000,24004833,25947983,-4052017,-0.135067
8/4/1995,Virtuosity,30000000,23998226,23998226,-6001774,-0.200059
9/18/1998,One True Thing,30000000,23337196,26708196,-3291804,-0.109727
2/4/2011,Sanctum,30000000,23209310,108957098,78957098,2.6319
7/21/2006,My Super Ex-Girlfriend,30000000,22530295,60772856,30772856,1.02576
12/16/2016,Ballerina,30000000,21858070,96890794,66890794,2.22969
9/17/2004,Mr. 3000,30000000,21800302,21827296,-8172704,-0.272423
6/14/2019,Shaft,30000000,21360215,21360215,-8639785,-0.287993
11/19/2010,The Next Three Days,30000000,21148651,67255916,37255916,1.24186
1/10/2018,Proud Mary,30000000,20868638,21709539,-8290461,-0.276349
1/11/2017,Sleepless,30000000,20783704,33296659,3296659,0.109889
8/6/2004,Little Black Book,30000000,20422207,21758371,-8241629,-0.274721
1/19/2005,Assault On Precinct 13,30000000,20040895,36040895,6040895,0.201363
8/5/2016,Nine Lives,30000000,19700032,57814445,27814445,0.927148
9/26/2013,Runner Runner,30000000,19316646,60512680,30512680,1.01709
2/6/1998,The Replacement Killers,30000000,19035741,19035741,-10964259,-0.365475
4/28/2017,Baahubali 2: The Conclusion,30000000,18985794,263502914,233502914,7.78343
3/3/2006,Ultraviolet,30000000,18522064,30962112,962112,0.0320704
10/21/2005,North Country,30000000,18324242,23676771,-6323229,-0.210774
8/19/2011,Fright Night,30000000,18298649,40520649,10520649,0.350688
9/15/2017,mother!,30000000,17800004,42531076,12531076,0.417703
10/9/2015,Steve Jobs,30000000,17766658,35579007,5579007,0.185967
3/7/2021,Spirit Untamed,30000000,17635215,42347383,12347383,0.411579
7/17/2002,Eight Legged Freaks,30000000,17266505,36722311,6722311,0.224077
7/19/1996,Fled,30000000,17192205,19892205,-10107795,-0.336927
6/4/2010,Splice,30000000,17010170,28542494,-1457506,-0.0485835
4/18/2008,88 Minutes,30000000,16930884,32955399,2955399,0.0985133
4/9/2004,The Whole Ten Yards,30000000,16323969,26323969,-3676031,-0.122534
8/1/1986,Howard the Duck,30000000,16295774,16295774,-13704226,-0.456808
10/24/2008,Pride and Glory,30000000,15740721,32262866,2262866,0.0754289
1/28/2021,The Little Things,30000000,15245157,29637633,-362367,-0.0120789
8/26/2005,The Cave,30000000,15007991,27147991,-2852009,-0.095067
4/30/2004,Godsend,30000000,14334645,16873925,-13126075,-0.437536
6/20/2003,Alex & Emma,30000000,14208384,15358583,-14641417,-0.488047
9/3/2004,Wicker Park,30000000,13001257,21577076,-8422924,-0.280764
12/25/2005,The New World,30000000,12712093,26184400,-3815600,-0.127187
6/29/2007,Evening,30000000,12406646,12885574,-17114426,-0.570481
1/17/2013,The Last Stand,30000000,12050299,48330757,18330757,0.611025
1/15/1999,In Dreams,30000000,12017369,12017369,-17982631,-0.599421
3/12/1999,Wing Commander,30000000,11578022,11578022,-18421978,-0.614066
5/20/2016,Café Society,30000000,11103205,44348292,14348292,0.478276
1/12/2001,Antitrust,30000000,10965209,17865209,-12134791,-0.404493
3/7/2013,Dead Man Down,30000000,10895295,19599974,-10400026,-0.346668
4/29/2011,Hoodwinked Too: Hood vs. Evil,30000000,10143779,23353111,-6646889,-0.221563
4/10/2009,Dragonball Evolution,30000000,9362785,56511457,26511457,0.883715
9/24/2004,First Daughter,30000000,9055010,10419084,-19580916,-0.652697
3/15/2017,The Lost City of Z,30000000,8574339,17121823,-12878177,-0.429273
9/9/2005,An Unfinished Life,30000000,8535575,18535575,-11464425,-0.382147
1/4/2017,The Space Between Us,30000000,7885294,16481405,-13518595,-0.45062
6/19/2019,Anna,30000000,7743794,32825218,2825218,0.0941739
12/25/2009,The Imaginarium of Doctor Parnassus,30000000,7689607,64352607,34352607,1.14509
1/14/2011,Barney's Version,30000000,7502560,8845575,-21154425,-0.705148
9/20/2002,Trapped,30000000,6916869,7005468,-22994532,-0.766484
7/17/2019,The Current War: Director’s Cut,30000000,5978673,12868552,-17131448,-0.571048
8/29/2018,Kin,30000000,5718096,10383524,-19616476,-0.653883
6/1/1984,Once Upon a Time in America,30000000,5321508,5576072,-24423928,-0.814131
9/13/2018,Johnny English Strikes Again,30000000,4412170,159378778,129378778,4.31263
9/22/2017,Stronger,30000000,4211129,8786287,-21213713,-0.707124
1/22/1999,Gloria,30000000,4167493,4967493,-25032507,-0.834417
10/25/2018,Replicas,30000000,4046429,9037427,-20962573,-0.698752
9/21/2007,The Assassination of Jesse James by the Coward …,30000000,3909149,15313631,-14686369,-0.489546
12/29/2004,The Merchant of Venice,30000000,3765585,18765585,-11234415,-0.37448
4/2/2003,The Good Thief,30000000,3517797,6460758,-23539242,-0.784641
8/17/2005,Supercross,30000000,3102550,3252550,-26747450,-0.891582
12/29/2006,Miss Potter,30000000,3005605,35891257,5891257,0.196375
8/7/2020,The Tax Collector,30000000,1044212,1309971,-28690029,-0.956334
5/5/2006,Wu ji,30000000,669625,35869934,5869934,0.195664
9/23/2011,Machine Gun Preacher,30000000,538690,3721988,-26278012,-0.875934
5/26/2017,Bilal: A New Breed of Hero,30000000,490973,648599,-29351401,-0.97838
6/15/2007,DOA: Dead or Alive,30000000,480314,7755686,-22244314,-0.741477
2/19/2010,Le Petit Nicolas,30000000,201857,52339566,22339566,0.744652
10/7/2011,Xinhai geming,30000000,135739,8593154,-21406846,-0.713562
2/21/2008,Genghis Khan: To the Ends of the Earth and Sea,30000000,3892,4874498,-25125502,-0.837517
1/16/2015,Wild Card,30000000,3200,4315789,-25684211,-0.85614
7/3/2014,United Passions,30000000,918,168832,-29831168,-0.994372
,Konferenz der Tiere,30000000,0,53048539,23048539,0.768285
5/15/2014,Grace of Monaco,30000000,0,25199891,-4800109,-0.160004
6/16/2017,Overdrive,30000000,0,11247280,-18752720,-0.625091
11/13/2015,Savva. Serdtse voyna,30000000,0,5015080,-24984920,-0.832831
4/13/2007,Goodbye Bafana,30000000,0,2717302,-27282698,-0.909423
4/17/2003,Ripley's Game,30000000,0,1692644,-28307356,-0.943579
11/28/2013,Space Pirate Captain Harlock,30000000,0,310985,-29689015,-0.989634
8/26/2016,Collide,29200000,2280004,5466698,-23733302,-0.812784
5/7/2015,Pitch Perfect 2,29000000,184296230,287215196,258215196,8.90397
11/18/2005,Walk the Line,29000000,119519402,187707495,158707495,5.47267
9/26/2018,Night School,29000000,77339130,103113446,74113446,2.55564
4/7/2016,The Boss,29000000,63077560,78652207,49652207,1.71215
12/27/1995,12 Monkeys,29000000,57141459,168841459,139841459,4.82212
9/12/2003,Once Upon a Time in Mexico,29000000,56330657,97413527,68413527,2.35909
12/19/1990,Awakenings,29000000,51636504,51636504,22636504,0.780569
4/14/2000,Keeping the Faith,29000000,37036404,45336404,16336404,0.563324
8/18/2017,Logan Lucky,29000000,27778642,49046121,20046121,0.691246
4/29/2016,Florence Foster Jenkins,29000000,27383770,56000339,27000339,0.931046
2/13/1998,The Borrowers,29000000,22619589,54045832,25045832,0.863649
1/10/2020,Like a Boss,29000000,22169514,26567902,-2432098,-0.0838654
12/5/2008,Frost/Nixon,29000000,18622031,28452945,-547055,-0.018864
11/12/2004,Seed of Chucky,29000000,17016190,24716190,-4283810,-0.147718
8/23/2002,Serving Sara,29000000,16930185,20146150,-8853850,-0.305305
12/31/2002,Confessions of a Dangerous Mind,29000000,16007718,33013805,4013805,0.138407
8/26/2009,Taking Woodstock,29000000,7460204,10066366,-18933634,-0.652884
11/6/1987,Cry Freedom,29000000,5899797,25899797,-3100203,-0.106904
4/8/2021,Voyagers,29000000,3149935,4131130,-24868870,-0.857547
9/24/1999,Mumford,28700000,4559569,4559569,-24140431,-0.84113
3/4/2005,The Jacket,28500000,6301131,15452978,-13047022,-0.45779
11/11/1992,Aladdin,28000000,217350219,504050219,476050219,17.0018
5/23/1984,Indiana Jones and the Temple of Doom,28000000,179880271,333080271,305080271,10.8957
8/14/2015,Straight Outta Compton,28000000,161197785,202182981,174182981,6.22082
7/20/2017,Girls Trip,28000000,115108515,140886353,112886353,4.03166
11/20/1998,The Rugrats Movie,28000000,100494685,140894685,112894685,4.03195
7/15/1988,Die Hard,28000000,81675242,139434346,111434346,3.9798
12/18/1985,Out of Africa,28000000,79096868,258210860,230210860,8.22182
4/6/2001,Along Came a Spider,28000000,74058698,105159085,77159085,2.75568
11/1/2017,A Bad Moms Christmas,28000000,72110659,127710550,99710550,3.56109
2/13/2013,Safe Haven,28000000,71399120,94050951,66050951,2.35896
12/11/2015,The Big Short,28000000,70259870,133162752,105162752,3.75581
8/8/2019,Scary Stories to Tell in the Dark,28000000,68947075,95607360,67607360,2.41455
11/7/2008,Role Models,28000000,67300955,94500826,66500826,2.37503
10/10/2014,Alexander and the Terrible Horrible No Good …,28000000,66954149,101379287,73379287,2.62069
2/6/2004,Miracle,28000000,64378093,64474705,36474705,1.30267
1/28/2013,Last Vegas,28000000,63914167,112914167,84914167,3.03265
1/26/2001,The Wedding Planner,28000000,60400856,94728529,66728529,2.38316
3/19/2004,Dawn of the Dead,28000000,58990765,103452875,75452875,2.69475
6/26/1981,For Your Eyes Only,28000000,54800000,195300000,167300000,5.975
6/15/2018,Tag,28000000,54730625,77024944,49024944,1.75089
12/14/2001,The Royal Tenenbaums,28000000,52353636,71430876,43430876,1.5511
4/25/2003,Identity,28000000,52131264,82119036,54119036,1.93282
10/5/2001,Serendipity,28000000,50255310,77477297,49477297,1.76705
4/16/2010,Kick-Ass,28000000,48071303,97531134,69531134,2.48325
9/28/2001,Zoolander,28000000,45172250,60780981,32780981,1.17075
9/16/1994,Timecop,28000000,44853581,102053581,74053581,2.64477
7/16/1993,Hocus Pocus,28000000,44101060,45147989,17147989,0.612428
7/27/2007,No Reservations,28000000,43107979,91943956,63943956,2.28371
11/11/2005,Pride & Prejudice,28000000,38372662,126549607,98549607,3.51963
8/12/2011,30 Minutes or Less,28000000,37053924,41146935,13146935,0.469533
12/22/2000,Dracula 2000,28000000,33000377,33000377,5000377,0.178585
6/25/1982,Blade Runner,28000000,32656328,39536029,11536029,0.412001
4/7/1995,Rob Roy,28000000,31390587,31390587,3390587,0.121092
2/21/2014,3 Days to Kill,28000000,30697999,38959900,10959900,0.391425
8/16/2013,Kick-Ass 2,28000000,28795985,63129909,35129909,1.25464
10/12/2007,We Own the Night,28000000,28563179,55307857,27307857,0.975281
9/19/2014,A Walk Among the Tombstones,28000000,26017685,62108587,34108587,1.21816
1/15/2010,The Spy Next Door,28000000,24307106,46752858,18752858,0.669745
4/23/2014,Brick Mansions,28000000,20396829,73421224,45421224,1.62219
5/12/2006,Just My Luck,28000000,17326650,38159905,10159905,0.362854
10/13/2000,Lost Souls,28000000,16779636,31320293,3320293,0.118582
8/19/2015,American Ultra,28000000,14439985,30295028,2295028,0.0819653
4/18/2003,Winged Migration,28000000,11689053,39134983,11134983,0.397678
2/4/2016,Pride and Prejudice and Zombies,28000000,10907291,16638300,-11361700,-0.405775
10/1/1999,Mystery Alaska,28000000,8891623,8891623,-19108377,-0.682442
8/24/2001,John Carpenter’s Ghosts of Mars,28000000,8434601,8434601,-19565399,-0.698764
7/11/1997,A Simple Wish,28000000,8165213,8165213,-19834787,-0.708385
10/30/2015,Our Brand is Crisis,28000000,7002261,8594558,-19405442,-0.693052
12/25/1997,Kundun,28000000,5686694,5686694,-22313306,-0.796904
10/3/2008,How to Lose Friends & Alienate People,28000000,2775593,12031443,-15968557,-0.570306
,Alatriste,28000000,0,22860477,-5139523,-0.183554
6/1/2007,Knocked Up,27500000,148761765,219265952,191765952,6.97331
6/10/1983,Octopussy,27500000,67900000,187500000,160000000,5.81818
6/26/2009,My Sister’s Keeper,27500000,49200230,96673002,69173002,2.51538
2/8/2008,Welcome Home Roscoe Jenkins,27500000,42436517,43607627,16107627,0.585732
1/13/2012,Joyful Noise,27500000,30932113,31157914,3657914,0.133015
12/14/1984,A Passage to India,27500000,27187653,27187896,-312104,-0.0113492
12/25/2006,Notes on a Scandal,27500000,17510118,50578411,23078411,0.839215
10/19/2007,Rendition,27500000,9736045,26939925,-560075,-0.0203664
10/28/2011,Anonymous,27500000,4463292,15815509,-11684491,-0.424891
3/18/2011,Limitless,27000000,79249455,155564919,128564919,4.76166
12/6/1991,Star Trek VI: The Undiscovered Country,27000000,74888996,96900000,69900000,2.58889
6/26/2019,Annabelle Comes Home,27000000,74152591,231252591,204252591,7.56491
6/7/2002,The Divine Secrets of the Ya-Ya Sisterhood,27000000,69586544,73826768,46826768,1.73432
10/3/1997,Kiss the Girls,27000000,60527873,60527873,33527873,1.24177
6/20/1980,The Blues Brothers,27000000,57229890,57245093,30245093,1.12019
12/25/1994,The Jungle Book,27000000,44342956,44342956,17342956,0.642332
8/6/2008,The Sisterhood of the Traveling Pants 2,27000000,44089964,44270131,17270131,0.639634
5/12/2016,Money Monster,27000000,41012075,93466095,66466095,2.46171
5/17/2002,About a Boy,27000000,40803000,130759651,103759651,3.84295
8/19/2011,Spy Kids: All the Time in the World,27000000,38536376,80681183,53681183,1.98819
7/16/1999,Lake Placid,27000000,31770413,31770413,4770413,0.176682
4/7/2006,Lucky Number Slevin,27000000,22495466,55495466,28495466,1.05539
10/21/1983,The Right Stuff,27000000,21500000,21500213,-5499787,-0.203696
7/20/1984,Die Unendliche Geschichte,27000000,21300000,21427947,-5572053,-0.206372
2/27/1998,Dark City,27000000,14435076,27257061,257061,0.00952078
9/19/2008,The Duchess,27000000,13848978,45160110,18160110,0.672597
10/1/2010,Case 39,27000000,13261851,28773827,1773827,0.0656973
6/10/2005,The Honeymooners,27000000,12834849,13174426,-13825574,-0.512058
6/21/1985,Return to Oz,27000000,10618813,10618813,-16381187,-0.606711
3/27/1998,The Newton Boys,27000000,10341093,10341093,-16658907,-0.616997
8/27/2004,Suspect Zero,27000000,8712564,8723600,-18276400,-0.676904
11/2/2007,Martian Child,27000000,7500310,9352089,-17647911,-0.653626
10/18/2002,Formula 51,27000000,5204007,5204007,-21795993,-0.807259
11/24/1999,Flawless,27000000,4485485,4485485,-22514515,-0.833871
5/13/2005,Mindhunters,27000000,4476235,16566235,-10433765,-0.386436
10/17/2008,What Just Happened,27000000,1090947,2412123,-24587877,-0.910662
12/12/2003,The Statement,27000000,765637,1545064,-25454936,-0.942775
10/4/2019,Lucy in the Sky,27000000,319976,325943,-26674057,-0.987928
6/10/2021,The Magic Flute,27000000,0,0,-27000000,-1
11/23/2016,Rules Don’t Apply,26700000,3652206,3871448,-22828552,-0.855002
1/16/2009,Paul Blart: Mall Cop,26000000,146336178,185904750,159904750,6.15018
8/6/2003,Freaky Friday,26000000,110222438,160822438,134822438,5.18548
8/19/2005,The 40 Year-old Virgin,26000000,109449237,176276839,150276839,5.77988
12/11/1998,Shakespeare in Love,26000000,100317794,279500000,253500000,9.75
12/21/1990,Kindergarten Cop,26000000,91457688,202000000,176000000,6.76923
8/6/2008,Pineapple Express,26000000,87341380,102404019,76404019,2.93862
12/22/1993,Philadelphia,26000000,77324422,201324422,175324422,6.74325
7/31/1998,Ever After: A Cinderella Story,26000000,65705772,65705772,39705772,1.52715
8/10/1990,Flatliners,26000000,61308153,61308153,35308153,1.35801
8/15/2003,Open Range,26000000,58331254,68613992,42613992,1.639
8/19/2005,Red Eye,26000000,57891803,96666486,70666486,2.71794
12/9/2011,New Year’s Eve,26000000,54544638,146850273,120850273,4.64809
6/15/1977,A Bridge Too Far,26000000,50800000,50800000,24800000,0.953846
4/24/2013,Pain & Gain,26000000,49875291,81275291,55275291,2.12597
1/31/2003,Final Destination 2,26000000,46896664,90396664,64396664,2.47679
12/22/2000,O Brother Where Art Thou?,26000000,45506619,75763814,49763814,1.91399
12/29/2004,In Good Company,26000000,45489752,63463195,37463195,1.44089
1/22/2010,Legion,26000000,40168080,67647574,41647574,1.60183
8/29/2012,Lawless,26000000,37397291,54393687,28393687,1.09206
3/29/2002,Clockstoppers,26000000,36985501,38788828,12788828,0.491878
7/10/1985,Silverado,26000000,33200000,33200000,7200000,0.276923
12/4/2009,Brothers,26000000,28544157,45043870,19043870,0.732457
10/17/2014,The Best of Me,26000000,26766213,41059418,15059418,0.579208
3/12/2004,Agent Cody Banks 2: Destination London,26000000,23514247,28703083,2703083,0.103965
11/23/2016,Bad Santa 2,26000000,17782176,23345113,-2654887,-0.102111
8/3/2001,Original Sin,26000000,16521410,16521410,-9478590,-0.364561
4/12/2012,The Raven,26000000,16008272,30601801,4601801,0.176992
2/20/2004,Welcome to Mooseport,26000000,14469428,14494770,-11505230,-0.442509
1/27/1995,Highlander: The Final Dimension,26000000,13738574,13738574,-12261426,-0.471593
6/8/2015,Self/Less,26000000,12279691,33667319,7667319,0.294897
11/1/2019,Motherless Brooklyn,26000000,9277736,18477736,-7522264,-0.289318
8/24/2001,The Curse of the Jade Scorpion,26000000,7496522,18496522,-7503478,-0.288595
2/12/2021,Judas and the Black Messiah,26000000,5453633,7033904,-18966096,-0.729465
10/18/2013,The Fifth Estate,26000000,3254172,6154172,-19845828,-0.763301
2/21/1997,Blood and Wine,26000000,1083350,1083350,-24916650,-0.958333
10/30/2013,Blood Ties,26000000,42472,2923959,-23076041,-0.88754
8/24/1997,The Grimm Brothers' Snow White,26000000,5000,5000,-25995000,-0.999808
6/30/2015,Viy,26000000,0,34246770,8246770,0.317183
3/17/2015,Accidental Love,26000000,0,135436,-25864564,-0.994791
4/24/2015,The Face of an Angel,26000000,0,0,-26000000,-1
5/17/1996,Flipper,25530000,20080020,30593313,5063313,0.198328
8/31/2005,The Constant Gardener,25500000,33579798,86301599,60801599,2.38438
10/17/2008,W.,25100000,25534493,28575778,3475778,0.138477
2/19/2004,The Passion of the Christ,25000000,370782930,622313635,597313635,23.8925
11/24/1993,Mrs. Doubtfire,25000000,219195051,441286003,416286003,16.6514
12/16/1988,Rain Man,25000000,172825435,412800000,387800000,15.512
8/10/2011,The Help,25000000,169705587,213120004,188120004,7.5248
12/25/2016,Hidden Figures,25000000,169607287,231771716,206771716,8.27087
12/12/2008,Gran Torino,25000000,148095302,274543085,249543085,9.98172
4/9/2008,Taken,25000000,145000989,226941585,201941585,8.07766
1/17/2014,Ride Along,25000000,134202565,153733800,128733800,5.14935
11/25/1992,The Bodyguard,25000000,121945720,410945720,385945720,15.4378
12/15/1993,Schindler’s List,25000000,96898818,322197132,297197132,11.8879
7/2/2003,Legally Blonde 2: Red White & Blonde,25000000,90639088,125339088,100339088,4.01356
3/26/2004,Scooby-Doo 2: Monsters Unleashed,25000000,84185387,180856996,155856996,6.23428
7/9/2004,Anchorman: The Legend of Ron Burgundy,25000000,84136909,89476265,64476265,2.57905
12/4/2009,Up in the Air,25000000,83823381,166842739,141842739,5.67371
8/15/2003,Freddy vs. Jason,25000000,82622655,114576403,89576403,3.58306
2/16/2007,Bridge to Terabithia,25000000,82234139,137984788,112984788,4.51939
12/21/2001,Jimmy Neutron: Boy Genius,25000000,80936232,102992536,77992536,3.1197
1/18/2008,Cloverfield,25000000,80048433,171302226,146302226,5.85209
2/5/2010,Dear John,25000000,80014842,142033509,117033509,4.68134
3/22/1991,Teenage Mutant Ninja Turtles II: The Secret of …,25000000,78656813,78656813,53656813,2.14627
12/25/2012,Parental Guidance,25000000,77267296,120832383,95832383,3.8333
6/3/1987,The Untouchables,25000000,76270454,76271995,51271995,2.05088
11/9/2007,No Country for Old Men,25000000,74273505,164035753,139035753,5.56143
4/13/2001,Bridget Jones's Diary,25000000,71500556,277902373,252902373,10.1161
12/15/2000,Chocolat,25000000,71309760,152500343,127500343,5.10001
1/21/2011,No Strings Attached,25000000,70662220,149228078,124228078,4.96912
1/13/2012,Contraband,25000000,66528000,98406855,73406855,2.93627
1/20/2017,A Dog’s Purpose,25000000,64321890,203055427,178055427,7.12222
4/19/2012,The Lucky One,25000000,60457138,96633833,71633833,2.86535
12/25/1993,Tombstone,25000000,56505065,56505065,31505065,1.2602
3/22/2000,Romeo Must Die,25000000,55973336,91036760,66036760,2.64147
6/6/2006,The Omen,25000000,54607383,119295584,94295584,3.77182
2/10/2006,Final Destination 3,25000000,54098051,112798051,87798051,3.51192
4/22/2011,Madea’s Big Happy Family,25000000,53345287,54160818,29160818,1.16643
12/13/2013,Tyler Perry's A Madea Christmas,25000000,52543354,52543354,27543354,1.10173
11/12/2004,Finding Neverland,25000000,51676606,115036108,90036108,3.60144
1/27/2012,The Grey,25000000,51580136,81249176,56249176,2.24997
1/28/2005,Hide and Seek,25000000,51100486,123696741,98696741,3.94787
5/23/1986,Cobra,25000000,49042224,49042224,24042224,0.961689
8/22/2008,The House Bunny,25000000,48237389,71390601,46390601,1.85562
3/14/2003,Agent Cody Banks,25000000,47545060,58240458,33240458,1.32962
1/27/2006,Nanny McPhee,25000000,47279279,128745578,103745578,4.14982
9/19/1990,Goodfellas,25000000,46743809,47103147,22103147,0.884126
8/15/2014,The Giver,25000000,45090374,66540205,41540205,1.66161
12/9/1983,Scarface,25000000,44942821,44942821,19942821,0.797713
7/18/1997,Nothing To Lose,25000000,44480039,64594061,39594061,1.58376
11/20/1987,The Last Emperor,25000000,43984987,44005434,19005434,0.760217
11/12/2015,The Night Before,25000000,43035725,52568099,27568099,1.10272
10/15/1993,The Beverly Hillbillies,25000000,42222647,55598481,30598481,1.22394
12/27/2002,The Hours,25000000,41675994,97030468,72030468,2.88122
8/22/1997,Money Talks,25000000,41076865,41076865,16076865,0.643075
12/26/2007,There Will Be Blood,25000000,40222514,77208711,52208711,2.08835
12/20/2002,The Wild Thornberrys Movie,25000000,40108697,60694737,35694737,1.42779
6/13/2003,Rugrats Go Wild,25000000,39402572,55443032,30443032,1.21772
6/1/2005,The Sisterhood of the Traveling Pants,25000000,39053061,41560117,16560117,0.662405
5/31/2002,Undercover Brother,25000000,38230435,40796145,15796145,0.631846
12/25/2013,August: Osage County,25000000,37738810,50738810,25738810,1.02955
7/6/2001,Kiss of the Dragon,25000000,36833473,36833473,11833473,0.473339
5/16/2014,Million Dollar Arm,25000000,36447959,39217912,14217912,0.568716
3/30/2005,Beauty Shop,25000000,36351350,38351350,13351350,0.534054
12/25/2019,Just Mercy,25000000,36001502,50401502,25401502,1.01606
4/4/2003,What a Girl Wants,25000000,35990505,37216643,12216643,0.488666
8/29/2003,Jeepers Creepers 2,25000000,35623801,119923801,94923801,3.79695
9/7/2018,Peppermint,25000000,35418723,51800758,26800758,1.07203
9/21/2007,Good Luck Chuck,25000000,35017297,60709968,35709968,1.4284
2/28/2003,Cradle 2 the Grave,25000000,34657731,56434942,31434942,1.2574
3/17/2006,She's the Man,25000000,33889159,55279608,30279608,1.21118
12/10/2014,The Gambler,25000000,33680992,38718031,13718031,0.548721
8/24/2007,Mr. Bean’s Holiday,25000000,33302167,234981342,209981342,8.39925
4/22/2016,Mother’s Day,25000000,32492859,52367022,27367022,1.09468
10/16/1998,Bride of Chucky,25000000,32404188,50692188,25692188,1.02769
2/17/2017,Fist Fight,25000000,32187017,40286416,15286416,0.611457
11/21/2007,August Rush,25000000,31664162,64605762,39605762,1.58423
8/27/2004,Anacondas: The Hunt for the Blood Orchid,25000000,31526393,70326393,45326393,1.81306
12/9/2011,The Sitter,25000000,30542576,38749404,13749404,0.549976
11/6/1998,Elizabeth,25000000,30082699,82150642,57150642,2.28603
9/23/2070,Tora! Tora! Tora!,25000000,29548291,29548291,4548291,0.181932
1/23/1998,Spice World,25000000,29342592,56042592,31042592,1.2417
4/11/2014,Draft Day,25000000,28842237,29847480,4847480,0.193899
9/23/1994,The Shawshank Redemption,25000000,28241469,28419106,3419106,0.136764
2/3/2017,Rings,25000000,27793018,82917283,57917283,2.31669
5/22/2009,Dance Flick,25000000,25794018,32224624,7224624,0.288985
4/20/2001,Crocodile Dundee in Los Angeles,25000000,25590119,39393111,14393111,0.575724
7/26/1996,Kingpin,25000000,25023424,32223424,7223424,0.288937
3/18/2005,Ice Princess,25000000,24381334,25732334,732334,0.0292934
8/26/2011,Don't Be Afraid of the Dark,25000000,24046682,39126427,14126427,0.565057
4/23/2010,The Losers,25000000,23591432,29863840,4863840,0.194554
4/24/2009,Fighting,25000000,23091010,32831707,7831707,0.313268
8/24/2007,War,25000000,22486409,40686409,15686409,0.627456
4/7/1995,Don Juan DeMarco,25000000,22032635,22032635,-2967365,-0.118695
4/22/2005,A Lot Like Love,25000000,21835784,41921590,16921590,0.676864
5/1/1998,He Got Game,25000000,21567853,22411948,-2588052,-0.103522
2/11/2011,The Eagle,25000000,19490041,38993548,13993548,0.559742
2/6/2015,Shaun the Sheep,25000000,19375982,101850986,76850986,3.07404
9/2/2011,Shark Night 3D,25000000,18877153,18877153,-6122847,-0.244914
3/23/2017,CHiPS,25000000,18600152,23190292,-1809708,-0.0723883
10/11/2002,Punch-Drunk Love,25000000,17791031,24591031,-408969,-0.0163588
2/20/2004,Eurotrip,25000000,17718223,20718223,-4281777,-0.171271
12/22/2017,Father Figures,25000000,17501244,21038441,-3961559,-0.158462
4/4/2008,The Ruins,25000000,17432844,22910563,-2089437,-0.0835775
9/23/2016,Masterminds,25000000,17356894,30850666,5850666,0.234027
10/25/2013,The Counselor,25000000,16973715,71009334,46009334,1.84037
12/8/2006,Unaccompanied Minors,25000000,16655224,21970831,-3029169,-0.121167
12/7/2018,Mary Queen of Scots,25000000,16648499,47020146,22020146,0.880806
4/1/1988,Bright Lights Big City,25000000,16118077,16118077,-8881923,-0.355277
11/15/2002,Half Past Dead,25000000,15567860,19233280,-5766720,-0.230669
4/18/1986,Legend,25000000,15502112,23506237,-1493763,-0.0597505
7/26/1996,The Adventures of Pinocchio,25000000,15382170,36682170,11682170,0.467287
9/30/2005,The Greatest Game Ever Played,25000000,15331289,15468266,-9531734,-0.381269
11/6/2009,The Box,25000000,15051977,34356760,9356760,0.37427
3/3/2000,The Next Best Thing,25000000,14983572,24355762,-644238,-0.0257695
10/8/2010,My Soul to Take,25000000,14744435,16727470,-8272530,-0.330901
4/9/2004,The Girl Next Door,25000000,14589444,31635150,6635150,0.265406
8/15/2008,Fly Me To the Moon,25000000,14543943,43530281,18530281,0.741211
9/13/1996,Maximum Risk,25000000,14102929,51702929,26702929,1.06812
9/13/2002,Stealing Harvard,25000000,13973532,13973532,-11026468,-0.441059
8/3/2007,Hot Rod,25000000,13938332,14371564,-10628436,-0.425137
11/24/2021,Resident Evil: Welcome to Raccoon City,25000000,13745647,24845647,-154353,-0.00617412
9/9/2011,Warrior,25000000,13657115,24215385,-784615,-0.0313846
12/24/1999,Angela's Ashes,25000000,13038660,13038660,-11961340,-0.478454
9/22/2017,Battle of the Sexes,25000000,12638526,18445379,-6554621,-0.262185
12/21/2012,Cirque du Soleil: Worlds Away,25000000,12512862,28012862,3012862,0.120514
8/6/2015,The 33,25000000,12227722,28287489,3287489,0.1315
6/21/1985,Lifeforce,25000000,11603545,11603545,-13396455,-0.535858
4/15/2011,The Conspirator,25000000,11538204,15907411,-9092589,-0.363704
7/3/2002,The Powerpuff Girls,25000000,11411644,16425701,-8574299,-0.342972
6/3/2005,The Lords of Dogtown,25000000,11273517,13424365,-11575635,-0.463025
7/1/1986,Big Trouble in Little China,25000000,11100000,11208970,-13791030,-0.551641
10/11/1996,Michael Collins,25000000,11092559,27572844,2572844,0.102914
3/28/2008,Stop-Loss,25000000,10915744,11229035,-13770965,-0.550839
10/8/1993,Gettysburg,25000000,10731997,10731997,-14268003,-0.57072
10/18/2002,Abandon,25000000,10719367,12219367,-12780633,-0.511225
9/16/2011,Straw Dogs,25000000,10324441,11253821,-13746179,-0.549847
8/13/1999,Brokedown Palace,25000000,10115014,11115766,-13884234,-0.555369
8/16/2002,Possession,25000000,10103647,14805812,-10194188,-0.407768
4/19/1996,Mrs. Winterbourne,25000000,10039566,10039566,-14960434,-0.598417
5/17/1991,Stone Cold,25000000,9286314,9286314,-15713686,-0.628547
1/24/2019,Serenity,25000000,8547045,13008804,-11991196,-0.479648
11/25/2009,The Road,25000000,8114270,29206732,4206732,0.168269
10/12/2018,Beautiful Boy,25000000,7634767,13314562,-11685438,-0.467418
4/6/2007,The Hoax,25000000,7164995,7164995,-17835005,-0.7134
3/14/2019,Captive State,25000000,5958315,9363210,-15636790,-0.625472
8/17/1984,Sheena,25000000,5778353,5778353,-19221647,-0.768866
9/2/2005,Underclassman,25000000,5654777,5654777,-19345223,-0.773809
3/23/2001,Say It Isn't So,25000000,5516708,5516708,-19483292,-0.779332
12/7/2005,The World's Fastest Indian,25000000,5128124,18991288,-6008712,-0.240348
4/25/2008,Deception,25000000,4598506,12850033,-12149967,-0.485999
3/1/1995,Tank Girl,25000000,4064333,4064333,-20935667,-0.837427
4/22/2005,King's Ransom,25000000,4008527,4049527,-20950473,-0.838019
8/23/2020,Bill & Ted Face the Music,25000000,3439660,6266609,-18733391,-0.749336
10/3/2008,Blindness,25000000,3073392,20052958,-4947042,-0.197882
4/13/2018,Sgt. Stubby: An American Hero,25000000,3054285,3823620,-21176380,-0.847055
12/16/2011,Carnage,25000000,2546747,38112154,13112154,0.524486
8/25/2017,Tulip Fever,25000000,2455635,6792768,-18207232,-0.728289
1/6/2006,BloodRayne,25000000,2405420,3711633,-21288367,-0.851535
9/11/2015,Legend,25000000,1872994,42425450,17425450,0.697018
11/20/2009,Bad Lieutenant: Port of Call New Orleans,25000000,1702112,12413949,-12586051,-0.503442
12/31/2015,Jane Got a Gun,25000000,1513793,3771345,-21228655,-0.849146
11/25/2009,Me and Orson Welles,25000000,1190003,1190003,-23809997,-0.9524
10/23/2020,All My Life,25000000,913935,2015472,-22984528,-0.919381
9/16/2005,Venom,25000000,881745,881745,-24118255,-0.96473
10/14/2005,Where the Truth Lies,25000000,872142,1415656,-23584344,-0.943374
9/11/1998,Without Limits,25000000,780326,780326,-24219674,-0.968787
5/23/2012,On the Road,25000000,720828,9313302,-15686698,-0.627468
8/24/2012,Les petits mouchoirs,25000000,205505,48530887,23530887,0.941235
6/30/2010,Love Ranch,25000000,137885,146149,-24853851,-0.994154
4/24/2015,Yi ge ren de wu lin,25000000,129115,129115,-24870885,-0.994835
,Sammy's avonturen: De geheime doorgang,25000000,0,71594792,46594792,1.86379
9/20/1996,Matilda,25000000,0,9755282,-15244718,-0.609789
3/18/2010,Belka i Strelka. Zvezdnye sobaki,25000000,0,9445081,-15554919,-0.622197
10/4/2011,La véritable histoire du Chat Botté,25000000,0,8208594,-16791406,-0.671656
3/15/2019,The Professor and the Madman,25000000,0,6352683,-18647317,-0.745893
7/8/2011,Ironclad,25000000,0,5297411,-19702589,-0.788104
6/20/2014,Red Sky,25000000,0,91116,-24908884,-0.996355
1/1/2070,Waterloo,25000000,0,0,-25000000,-1
1/10/2014,The Adventurer: The Curse of the Midas Box,25000000,0,0,-25000000,-1
,Reagan,25000000,0,0,-25000000,-1
11/9/2012,Dangerous Liaisons,24200000,17000,10447579,-13752421,-0.568282
11/26/1986,Star Trek IV: The Voyage Home,24000000,109713132,133000000,109000000,4.54167
12/12/1997,Scream 2,24000000,101363301,172363301,148363301,6.1818
10/11/2019,The Addams Family,24000000,97864733,200612027,176612027,7.35883
2/21/2003,Old School,24000000,75155000,86737464,62737464,2.61406
12/20/2006,Rocky Balboa,24000000,70269899,156229050,132229050,5.50954
6/18/2014,Think Like a Man Too,24000000,65028687,70027933,46027933,1.91783
12/16/2016,Fences,24000000,57682904,64282881,40282881,1.67845
2/18/2000,The Whole Nine Yards,24000000,57262492,85527867,61527867,2.56366
10/14/2011,Footloose,24000000,51802742,62989834,38989834,1.62458
4/5/2017,Going in Style,24000000,45018541,80812424,56812424,2.36718
7/12/1991,Point Break,24000000,43218387,83531958,59531958,2.4805
9/20/1991,The Fisher King,24000000,41798224,41798224,17798224,0.741593
11/13/1998,I Still Know What You Did Last Summer,24000000,40020622,40020622,16020622,0.667526
11/21/2007,Hitman,24000000,39687694,99135571,75135571,3.13065
12/16/2069,Hello Dolly,24000000,33208099,33208099,9208099,0.383671
4/7/2000,Return to Me,24000000,32662299,32662299,8662299,0.360929
11/6/2009,The Men Who Stare at Goats,24000000,32428195,67348218,43348218,1.80618
10/31/2008,Zack and Miri Make a Porno,24000000,31457946,36856306,12856306,0.535679
1/12/2001,Double Take,24000000,29823162,29823162,5823162,0.242632
12/21/1999,Girl Interrupted,24000000,28871190,48308749,24308749,1.01286
9/8/2000,Nurse Betty,24000000,25170054,27732366,3732366,0.155515
8/20/2010,Piranha 3D,24000000,25003155,83660160,59660160,2.48584
11/24/2010,Faster,24000000,23240020,35792945,11792945,0.491373
8/4/1989,Lock Up,24000000,22099847,22099847,-1900153,-0.079173
10/24/1978,The Wiz,24000000,22000000,22000000,-2000000,-0.0833333
1/23/2004,Win a Date with Tad Hamilton!,24000000,16980098,17589829,-6410171,-0.26709
7/14/1999,Muppets From Space,24000000,16304786,16304786,-7695214,-0.320634
4/7/2000,Ready to Rumble,24000000,12372410,12372410,-11627590,-0.484483
11/14/2014,Foxcatcher,24000000,12096300,19303058,-4696942,-0.195706
9/16/2011,I Don't Know How She Does It,24000000,9659074,24474463,474463,0.0197693
12/24/1999,Play it to the Bone,24000000,8427204,8427204,-15572796,-0.648867
12/19/2013,Dhoom 3,24000000,8031955,11723620,-12276380,-0.511516
12/17/2004,Beyond the Sea,24000000,6144806,8292914,-15707086,-0.654462
6/10/2005,Hauru no ugoku shiro,24000000,4710455,237814327,213814327,8.90893
3/27/1998,Meet the Deedles,24000000,4356126,4356126,-19643874,-0.818495
8/25/1995,The Thief and the Cobbler,24000000,669276,669276,-23330724,-0.972113
6/10/2005,The Bridge of San Luis Rey,24000000,49981,1696765,-22303235,-0.929301
,Flood,24000000,0,4084232,-19915768,-0.829824
11/4/2021,Annaatthe,24000000,0,449486,-23550514,-0.981271
10/2/2009,Zombieland,23600000,75590286,102236596,78636596,3.33206
5/20/1980,Star Wars Ep. V: The Empire Strikes Back,23000000,291738960,549001242,526001242,22.8696
11/6/1998,The Waterboy,23000000,161491646,190191646,167191646,7.2692
6/28/1991,The Naked Gun 2½: The Smell of Fear,23000000,86930411,86930411,63930411,2.77958
11/16/2018,Green Book,23000000,85080171,320029388,297029388,12.9143
8/11/1995,Dangerous Minds,23000000,84919401,178919401,155919401,6.7791
4/7/1995,Bad Boys,23000000,65647413,141247413,118247413,5.14119
1/16/2015,The Wedding Ringer,23000000,64460211,80171596,57171596,2.48572
3/17/2000,Final Destination,23000000,53302314,112036870,89036870,3.87117
12/17/1976,King Kong,23000000,52614445,90614445,67614445,2.93976
10/7/2011,The Ides of March,23000000,40962534,77735925,54735925,2.37982
2/18/2000,Pitch Black,23000000,39235088,53182088,30182088,1.31226
10/5/2018,The Hate U Give,23000000,29719483,35067665,12067665,0.524681
3/30/2001,Someone Like You,23000000,27338033,38684906,15684906,0.681952
1/10/2014,Her,23000000,25568251,48043998,25043998,1.08887
10/5/2001,Joy Ride,23000000,21973182,22204890,-795110,-0.03457
1/12/2012,Kari gurashi no Arietti,23000000,19192510,151496097,128496097,5.58679
1/20/2012,Haywire,23000000,18942396,36374700,13374700,0.581509
11/12/1999,Anywhere But Here,23000000,18653615,18653615,-4346385,-0.188973
9/1/2004,Vanity Fair,23000000,16123851,19123851,-3876149,-0.168528
2/26/2016,Eddie the Eagle,23000000,15789389,45060480,22060480,0.959151
7/17/1987,Jaws 4: The Revenge,23000000,15728335,15728335,-7271665,-0.316159
1/15/2021,The Marksman,23000000,15566093,21197274,-1802726,-0.0783794
3/5/2020,The Way Back,23000000,13590514,14563409,-8436591,-0.366808
8/25/2000,The Crew,23000000,13019253,13019253,-9980747,-0.433946
12/20/1996,Marvin's Room,23000000,12803305,12803305,-10196695,-0.443335
1/9/2004,Chasing Liberty,23000000,12189514,12291975,-10708025,-0.465566
8/22/2008,The Longshots,23000000,11511323,11778396,-11221604,-0.487896
12/3/1999,The End of the Affair,23000000,10660147,10660147,-12339853,-0.536515
8/23/1991,Harley Davidson and the Marlboro Man,23000000,7018525,7018525,-15981475,-0.694847
9/14/2007,In the Valley of Elah,23000000,6777741,24489150,1489150,0.0647457
9/25/2009,Coco avant Chanel,23000000,6113834,50813834,27813834,1.2093
6/26/2009,Chéri,23000000,2715657,2715657,-20284343,-0.881928
6/28/2013,Redemption,23000000,36686,13593473,-9406527,-0.408979
4/25/2008,Rogue,23000000,10452,4673377,-18326623,-0.79681
4/27/2017,Chāi dàn zhuānjiā,23000000,0,58807172,35807172,1.55683
1/21/2010,Shi Yue Wei Cheng,23000000,0,44195779,21195779,0.921556
6/24/1987,Spaceballs,22700000,38119483,38119483,15419483,0.679272
6/22/2007,1408,22500000,71985628,131263370,108763370,4.83393
11/4/2016,Nocturnal Animals,22500000,10663357,32398681,9898681,0.439941
12/26/2014,The Water Diviner,22500000,4200117,31054727,8554727,0.38021
7/13/1990,Ghost,22000000,217631306,517600000,495600000,22.5273
7/15/1998,There's Something About Mary,22000000,176484651,369884651,347884651,15.8129
11/11/1994,The Santa Clause,22000000,145539357,190506000,168506000,7.65936
9/6/2018,The Nun,22000000,117450119,363391647,341391647,15.5178
9/28/2007,The Game Plan,22000000,90648202,146590987,124590987,5.66323
3/29/2002,The Rookie,22000000,75600072,80491516,58491516,2.65871
6/2/1995,The Bridges of Madison County,22000000,71516617,175516617,153516617,6.97803
2/28/2014,Son of God,22000000,59700064,70949793,48949793,2.22499
6/1/2001,The Animal,22000000,55762229,55762229,33762229,1.53465
8/8/2014,The Hundred-Foot Journey,22000000,54235441,94270488,72270488,3.28502
12/8/1982,Gandhi,22000000,52767889,127767889,105767889,4.80763
9/19/2003,Underworld,22000000,51970690,95708457,73708457,3.35038
7/28/1995,The Net,22000000,50621733,110521733,88521733,4.02372
8/3/2012,Diary of a Wimpy Kid: Dog Days,22000000,49008662,77229695,55229695,2.51044
12/28/2001,I Am Sam,22000000,40270895,92542418,70542418,3.20647
12/27/2019,The Gentlemen,22000000,36471796,113876604,91876604,4.17621
11/11/2005,Derailed,22000000,36020063,57520063,35520063,1.61455
9/18/2009,The Informant!,22000000,33316821,41771168,19771168,0.898689
11/21/2013,Delivery Man,22000000,30659817,55616322,33616322,1.52801
2/5/2016,Hail Caesar!,22000000,30080225,64220196,42220196,1.9191
8/24/2001,Jay and Silent Bob Strike Back,22000000,30059386,33762400,11762400,0.534655
12/29/1993,Shadowlands,22000000,25842377,25842377,3842377,0.174653
8/27/2008,Traitor,22000000,23530831,27882226,5882226,0.267374
8/12/2005,Deuce Bigalow: European Gigolo,22000000,22400154,45273464,23273464,1.05788
5/19/2017,Diary of a Wimpy Kid: The Long Haul,22000000,20738724,35609577,13609577,0.618617
1/18/2008,Mad Money,22000000,20668843,25044057,3044057,0.138366
11/27/2013,Homefront,22000000,20158492,51695362,29695362,1.34979
9/19/2008,Igor,22000000,19528602,31013349,9013349,0.409698
2/9/2001,Saving Silverman,22000000,19351569,25873142,3873142,0.176052
7/2/1999,Summer of Sam,22000000,19288130,19288130,-2711870,-0.123267
9/14/2001,The Glass House,22000000,17951431,22861785,861785,0.039172
9/2/2015,The Transporter Refueled,22000000,16029670,69698495,47698495,2.16811
6/13/1980,The Island,22000000,15716828,15716828,-6283172,-0.285599
4/11/2001,Josie and the Pussycats,22000000,14252830,14307223,-7692777,-0.349672
8/22/2012,Hit & Run,22000000,13749300,17216955,-4783045,-0.217411
10/13/2000,The Little Vampire,22000000,13555988,13560782,-8439218,-0.383601
10/1/2004,I Heart Huckabees,22000000,12784713,20034713,-1965287,-0.0893312
11/17/2017,Roman J. Israel Esq.,22000000,11962712,12967012,-9032988,-0.41059
12/4/2013,Out of the Furnace,22000000,11330849,15434375,-6565625,-0.298438
11/5/1993,RoboCop 3,22000000,10696210,10696210,-11303790,-0.513809
8/27/1999,Dudley Do-Right,22000000,9818792,9818792,-12181208,-0.553691
12/8/2017,Just Getting Started,22000000,6069605,6756412,-15243588,-0.69289
9/21/2001,Megiddo: Omega Code 2,22000000,6047691,6047691,-15952309,-0.725105
6/24/2070,Darling Lili,22000000,5000000,5000000,-17000000,-0.772727
11/23/2005,The Libertine,22000000,4835065,9448623,-12551377,-0.570517
4/6/2007,Zwartboek,22000000,4398532,27238354,5238354,0.238107
10/31/2014,Before I Go to Sleep,22000000,3242457,19563579,-2436421,-0.110746
10/8/2010,Stone,22000000,1810078,4065020,-17934980,-0.815226
3/3/2006,Joyeux Noël,22000000,1054361,23134075,1134075,0.0515489
7/18/2013,Metegol,22000000,0,34061097,12061097,0.548232
6/24/1977,Sorcerer,21600000,12000000,12006010,-9593990,-0.444166
7/27/2007,Molière,21600000,635733,791154,-20808846,-0.963372
10/5/2007,Michael Clayton,21500000,49033882,92987651,71487651,3.32501
7/9/1999,Arlington Road,21500000,24419219,24419219,2919219,0.135778
12/20/1996,My Fellow Americans,21500000,22331846,22331846,831846,0.0386905
4/20/2012,To Rome with Love,21500000,16684352,74290305,52790305,2.45536
11/16/2012,Silver Linings Playbook,21000000,132092958,236412453,215412453,10.2577
3/29/2018,Blockers,21000000,60311495,94523781,73523781,3.50113
4/5/2019,Pet Sematary,21000000,54724696,111809732,90809732,4.32427
6/30/1999,South Park: Bigger Longer & Uncut,21000000,52037603,52037603,31037603,1.47798
6/18/1982,Firefox,21000000,45785720,45785720,24785720,1.18027
4/16/2010,Death at a Funeral,21000000,42739347,48977233,27977233,1.33225
3/19/1993,Teenage Mutant Ninja Turtles III,21000000,42273609,42273609,21273609,1.01303
9/14/2001,Hardball,21000000,40222729,43728560,22728560,1.08231
11/5/2010,For Colored Girls,21000000,37729698,38017873,17017873,0.810375
1/5/2007,Freedom Writers,21000000,36605602,43632609,22632609,1.07774
5/8/2019,The Hustle,21000000,35417038,97409779,76409779,3.63856
8/4/2017,Kidnap,21000000,30718107,34836080,13836080,0.658861
10/11/2002,The Transporter,21000000,25296447,43928932,22928932,1.09185
3/14/2008,Never Back Down,21000000,24850922,39319801,18319801,0.872371
12/9/2011,Tinker Tailor Soldier Spy,21000000,24149393,81428388,60428388,2.87754
9/13/2017,Victoria and Abdul,21000000,22245070,68271146,47271146,2.25101
11/5/1999,The Bachelor,21000000,21731001,36882378,15882378,0.756304
3/12/1999,The Rage: Carrie 2,21000000,17760244,17760244,-3239756,-0.154274
8/1/2008,Swing Vote,21000000,16289867,17589867,-3410133,-0.162387
6/5/2009,Away We Go,21000000,9451946,10108016,-10891984,-0.518666
9/27/2002,Moonlight Mile,21000000,6830957,6830957,-14169043,-0.674716
5/6/2011,The Beaver,21000000,970816,5046038,-15953962,-0.759712
2/24/2017,Bitter Harvest,21000000,557241,606162,-20393838,-0.971135
10/22/1999,Molly,21000000,17396,17396,-20982604,-0.999172
3/15/2015,Robot Overlords,21000000,0,991329,-20008671,-0.952794
2/1/2019,Velvet Buzzsaw,21000000,0,0,-21000000,-1
9/12/2019,Hustlers,20700000,104963598,150472713,129772713,6.26921
4/23/1999,eXistenZ,20700000,2840417,2840417,-17859583,-0.862782
7/23/1982,The Best Little Whorehouse in Texas,20500000,69701637,69701637,49201637,2.40008
8/11/2006,Pulse,20500000,20264436,30241435,9741435,0.475192
6/12/1981,Raiders of the Lost Ark,20000000,225686079,367452079,347452079,17.3726
11/13/1991,Beauty and the Beast,20000000,206333165,438656843,418656843,20.9328
3/20/2019,Us,20000000,175084580,256091919,236091919,11.8046
11/20/1992,Home Alone 2: Lost in New York,20000000,173585516,358994850,338994850,16.9497
11/16/1977,Close Encounters of the Third Kind,20000000,169100479,340800479,320800479,16.04
5/20/1987,Beverly Hills Cop II,20000000,153665036,276665036,256665036,12.8333
11/30/2016,La La Land,20000000,151101803,444535865,424535865,21.2268
7/18/2013,The Conjuring,20000000,137400141,317744402,297744402,14.8872
3/7/2003,Bringing Down the House,20000000,132675402,164675402,144675402,7.23377
10/17/2017,Wonder,20000000,132422809,311940097,291940097,14.597
2/14/1991,The Silence of the Lambs,20000000,130726716,275726716,255726716,12.7863
2/14/1992,Wayne's World,20000000,121697323,183097323,163097323,8.15487
10/15/2010,Jackass 3D,20000000,117229692,171685793,151685793,7.58429
7/29/2016,Bad Moms,20000000,113257297,180485601,160485601,8.02428
1/17/2019,Glass,20000000,111048468,246999039,226999039,11.35
6/16/1978,Jaws 2,20000000,102922376,208900376,188900376,9.44502
10/3/2008,Beverly Hills Chihuahua,20000000,94514402,154218168,134218168,6.71091
10/14/2021,Halloween Kills,20000000,91991205,130872938,110872938,5.54365
7/2/2014,Tammy,20000000,84525432,96407655,76407655,3.82038
8/14/2019,Good Boys,20000000,83140306,111173598,91173598,4.55868
1/21/2005,Are We There Yet?,20000000,82674398,98114471,78114471,3.90572
11/16/2011,The Descendants,20000000,82624961,175507800,155507800,7.77539
10/3/2003,School of Rock,20000000,81261177,131944672,111944672,5.59723
4/13/2007,Disturbia,20000000,80818974,118537627,98537627,4.92688
7/29/1988,Cocktail,20000000,78222753,78222753,58222753,2.91114
7/16/1993,Free Willy,20000000,77698625,153698625,133698625,6.68493
2/27/2019,Tyler Perry’s A Madea Family Funeral,20000000,73257045,74781999,54781999,2.7391
10/21/2016,Tyler Perry’s Boo! A Madea Halloween,20000000,73206343,73206343,53206343,2.66032
8/18/1995,Mortal Kombat,20000000,70433227,122133227,102133227,5.10666
6/23/2004,White Chicks,20000000,69148997,111448997,91448997,4.57245
4/24/2009,Obsessed,20000000,68261644,73964713,53964713,2.69824
4/18/2003,Holes,20000000,67383924,71232214,51232214,2.56161
6/29/2012,Tyler Perry's Madea's Witness Protection,20000000,65653242,66950887,46950887,2.34754
3/31/2010,The Last Song,20000000,62950384,92678948,72678948,3.63395
4/2/2010,Why Did I Get Married Too?,20000000,60095852,60831067,40831067,2.04155
10/23/1998,La vita è bella,20000000,57598247,229375361,209375361,10.4688
3/3/2017,The Shack,20000000,57386418,96908458,76908458,3.84542
10/18/2013,12 Years a Slave,20000000,56671993,180765061,160765061,8.03825
12/13/2002,Drumline,20000000,56398162,56398875,36398875,1.81994
6/1/2016,Me Before You,20000000,56245075,208064908,188064908,9.40325
2/8/2019,What Men Want,20000000,54611903,69911903,49911903,2.4956
4/15/2016,Barbershop: The Next Cut,20000000,54030051,54404202,34404202,1.72021
12/7/1990,Edward Scissorhands,20000000,53976987,53980220,33980220,1.69901
9/12/2018,A Simple Favor,20000000,53548586,97628717,77628717,3.88144
1/9/2015,Selma,20000000,52076908,66776576,46776576,2.33883
8/11/1995,A Walk in the Clouds,20000000,50008143,50008143,30008143,1.50041
12/12/1980,Popeye,20000000,49823037,49823037,29823037,1.49115
2/17/2006,Date Movie,20000000,48548426,85146165,65146165,3.25731
2/15/2002,Peter Pan: Return to Neverland,20000000,48430258,109862682,89862682,4.49313
2/14/2003,The Jungle Book 2,20000000,47901582,139924202,119924202,5.99621
3/16/2007,Premonition,20000000,47852604,84146832,64146832,3.20734
10/20/2017,Tyler Perry’s Boo 2! A Madea Halloween,20000000,47319572,47879572,27879572,1.39398
2/4/2005,Boogeyman,20000000,46752382,67192859,47192859,2.35964
2/11/2000,The Tigger Movie,20000000,45542421,96147688,76147688,3.80738
11/6/2015,Spotlight,20000000,45055776,91902438,71902438,3.59512
11/27/2019,Queen & Slim,20000000,43808310,47936399,27936399,1.39682
3/29/2018,Acrimony,20000000,43549096,46627836,26627836,1.33139
6/25/2015,Max,20000000,42656255,43658157,23658157,1.18291
3/21/2008,Meet the Browns,20000000,41975388,41975388,21975388,1.09877
7/24/2009,Orphan,20000000,41596251,78769428,58769428,2.93847
11/15/2017,The Star,20000000,40847995,62706947,42706947,2.13535
1/26/2007,Epic Movie,20000000,39739367,86858578,66858578,3.34293
9/19/2008,Lakeview Terrace,20000000,39263506,44821299,24821299,1.24106
10/13/2006,The Grudge 2,20000000,39143839,70743839,50743839,2.53719
7/27/2016,Nerve,20000000,38583626,85583945,65583945,3.2792
5/14/1982,Conan the Barbarian,20000000,38264085,79114085,59114085,2.9557
8/14/1998,How Stella Got Her Groove Back,20000000,37672944,37672944,17672944,0.883647
7/19/1991,Bill & Ted's Bogus Journey,20000000,37537675,37540024,17540024,0.877001
10/13/2006,Man of the Year,20000000,37442180,41342180,21342180,1.06711
2/18/2016,Risen,20000000,36880033,46244066,26244066,1.3122
8/18/2010,Vampires Suck,20000000,36661504,81424988,61424988,3.07125
12/21/1979,The Black Hole,20000000,35841901,35841901,15841901,0.792095
9/1/2010,The American,20000000,35606376,67950723,47950723,2.39754
3/21/1997,Selena,20000000,35450113,35450113,15450113,0.772506
11/4/2011,A Very Harold & Kumar 3D Christmas,20000000,35061031,36265745,16265745,0.813287
3/19/2004,Eternal Sunshine of the Spotless Mind,20000000,34366518,72401378,52401378,2.62007
1/4/2013,Texas Chainsaw 3D,20000000,34341945,47666013,27666013,1.3833
10/27/2006,Babel,20000000,34302837,132121212,112121212,5.60606
9/19/2014,This is Where I Leave You,20000000,34296320,41296320,21296320,1.06482
12/12/2008,Doubt,20000000,33446470,53191101,33191101,1.65956
10/15/2004,Team America: World Police,20000000,32774834,50948811,30948811,1.54744
10/27/1995,Copycat,20000000,32051917,32051917,12051917,0.602596
4/11/2013,Scary Movie V,20000000,32015787,78613981,58613981,2.9307
3/12/2010,She's Out of My League,20000000,32010860,48680977,28680977,1.43405
11/26/2008,Milk,20000000,31841299,57293371,37293371,1.86467
10/15/2069,Paint Your Wagon,20000000,31678778,31678778,11678778,0.583939
8/31/2011,The Debt,20000000,31177548,46604054,26604054,1.3302
10/25/2002,Ghost Ship,20000000,30113491,68349884,48349884,2.41749
1/8/2010,Daybreakers,20000000,30101577,51445503,31445503,1.57228
3/7/2008,The Bank Job,20000000,30060660,66143005,46143005,2.30715
3/20/1998,Wild Things,20000000,29795299,55576699,35576699,1.77883
10/16/2009,The Stepfather,20000000,29062561,29227561,9227561,0.461378
3/31/2000,High Fidelity,20000000,27277055,47881663,27881663,1.39408
4/28/2006,Stick It,20000000,26910736,30399714,10399714,0.519986
1/4/2008,One Missed Call,20000000,26890041,44513466,24513466,1.22567
1/12/1996,Eye for an Eye,20000000,26792700,26792700,6792700,0.339635
4/11/2008,Street Kings,20000000,26418667,65457811,45457811,2.27289
7/19/2013,The World's End,20000000,26004851,47124638,27124638,1.35623
1/19/1996,From Dusk Till Dawn,20000000,25728961,25736162,5736162,0.286808
9/24/2010,You Again,20000000,25702053,32838945,12838945,0.641947
6/15/2007,Nancy Drew,20000000,25584685,30703845,10703845,0.535192
9/17/2010,Alpha and Omega 3D,20000000,25107267,48958353,28958353,1.44792
11/23/2018,On the Basis of Sex,20000000,24704837,38837336,18837336,0.941867
2/14/2014,Endless Love,20000000,23438250,34718173,14718173,0.735909
9/8/2006,The Covenant,20000000,23364784,38164784,18164784,0.908239
5/12/2021,Spiral,20000000,23216862,39522047,19522047,0.976102
7/1/2011,Monte Carlo,20000000,23186769,39686769,19686769,0.984338
3/24/2006,Stay Alive,20000000,23086480,23187506,3187506,0.159375
10/7/2005,2 For the Money,20000000,22991379,30491379,10491379,0.524569
6/14/2017,Rough Night,20000000,22105643,46844357,26844357,1.34222
12/4/1998,Psycho,20000000,21541218,37226218,17226218,0.861311
10/19/1990,Quigley Down Under,20000000,21413105,21413105,1413105,0.0706553
9/27/1995,To Die For,20000000,21284514,27688744,7688744,0.384437
8/21/2009,Shorts,20000000,20919166,29870801,9870801,0.49354
10/30/1998,Vampires,20000000,20268825,20268825,268825,0.0134413
9/19/2008,Appaloosa,20000000,20211394,27911453,7911453,0.395573
11/12/2015,Secret in Their Eyes,20000000,20180155,32608019,12608019,0.630401
8/13/2004,Yu-Gi-Oh,20000000,19762690,28715003,8715003,0.43575
3/23/2007,Reign Over Me,20000000,19661987,20081987,81987,0.00409935
9/19/2008,My Best Friend's Girl,20000000,19219250,34787111,14787111,0.739356
5/11/2007,Georgia Rule,20000000,18882880,20819601,819601,0.04098
7/31/1981,Under the Rainbow,20000000,18826490,18826490,-1173510,-0.0586755
4/12/1985,Ladyhawke,20000000,18400000,18400000,-1600000,-0.08
9/21/2007,Into the Wild,20000000,18354356,56822960,36822960,1.84115
9/11/1998,Simon Birch,20000000,18253415,18310591,-1689409,-0.0844705
2/11/2005,Pooh's Heffalump Movie,20000000,18098433,55686944,35686944,1.78435
9/29/2006,School for Scoundrels,20000000,17807569,17807569,-2192431,-0.109622
8/29/2018,Operation Finale,20000000,17612099,17612099,-2387901,-0.119395
10/26/2012,Silent Hill: Revelation 3D,20000000,17530219,55975672,35975672,1.79878
11/3/1995,Home for the Holidays,20000000,17468887,22119269,2119269,0.105963
3/24/2017,The Zookeeper’s Wife,20000000,17445186,26308749,6308749,0.315437
2/20/2009,Fired Up,20000000,17231291,18608570,-1391430,-0.0695715
9/14/2004,Kung Fu Hustle,20000000,17104669,102034104,82034104,4.10171
7/26/2002,The Country Bears,20000000,16988996,16988996,-3011004,-0.15055
9/27/2017,Flatliners,20000000,16883115,45173738,25173738,1.25869
3/16/2007,Dead Silence,20000000,16574590,20614661,614661,0.0307331
11/21/2003,21 Grams,20000000,16248701,59667625,39667625,1.98338
12/4/2009,Armored,20000000,15988876,23661038,3661038,0.183052
12/14/2007,The Kite Runner,20000000,15800078,74180745,54180745,2.70904
9/3/2004,Paparazzi,20000000,15712072,16612072,-3387928,-0.169396
1/17/2003,A Guy Thing,20000000,15543862,17430594,-2569406,-0.12847
2/15/2065,The Greatest Story Ever Told,20000000,15473333,15473333,-4526667,-0.226333
7/21/2000,Loser,20000000,15464026,18250106,-1749894,-0.0874947
3/6/1998,Twilight,20000000,15055091,15055091,-4944909,-0.247245
9/23/2009,Capitalism: A Love Story,20000000,14363397,19121531,-878469,-0.0439235
4/13/2012,Lockout,20000000,14326865,33943049,13943049,0.697152
8/29/2008,Disaster Movie,20000000,14190901,36720752,16720752,0.836038
9/30/2011,What's Your Number?,20000000,14011084,30163785,10163785,0.508189
11/14/1997,The Man Who Knew Too Little,20000000,13801755,13801755,-6198245,-0.309912
4/17/2009,Crank 2: High Voltage,20000000,13684249,35472739,15472739,0.773637
10/22/2015,Burnt,20000000,13651946,36766293,16766293,0.838315
4/30/2004,Envy,20000000,13548322,14566246,-5433754,-0.271688
10/13/2006,One Night with the King,20000000,13395961,13725032,-6274968,-0.313748
10/21/1994,Bullets Over Broadway,20000000,13383747,13383747,-6616253,-0.330813
9/19/2008,Ghost Town,20000000,13367624,29958228,9958228,0.497911
11/22/2002,The Quiet American,20000000,12987647,26348203,6348203,0.31741
2/19/2016,Triple 9,20000000,12639297,25943792,5943792,0.29719
9/2/2016,The Light Between Oceans,20000000,12545979,22281732,2281732,0.114087
10/28/2005,The Weather Man,20000000,12482775,15466961,-4533039,-0.226652
8/23/2002,Undisputed,20000000,12398628,12398628,-7601372,-0.380069
3/27/2009,12 Rounds,20000000,12234694,17306648,-2693352,-0.134668
10/1/2010,Let Me In,20000000,12134935,28270399,8270399,0.41352
5/6/1994,3 Ninjas Kick Back,20000000,11744960,11744960,-8255040,-0.412752
2/22/2008,Be Kind Rewind,20000000,11175164,30894247,10894247,0.544712
12/9/2005,Mrs. Henderson Presents,20000000,11036366,27836366,7836366,0.391818
12/12/1997,Deconstructing Harry,20000000,10686841,10686841,-9313159,-0.465658
10/22/1999,Three to Tango,20000000,10570375,10570375,-9429625,-0.471481
12/15/1989,We're No Angels,20000000,10555348,10555348,-9444652,-0.472233
12/6/1996,Everyone Says I Love You,20000000,9725847,34600000,14600000,0.73
8/31/2007,Death Sentence,20000000,9534258,16907831,-3092169,-0.154608
6/3/2016,Popstar: Never Stop Never Stopping,20000000,9496130,9537120,-10462880,-0.523144
10/27/2017,Thank You for Your Service,20000000,9479390,9985316,-10014684,-0.500734
12/4/2009,Everybody's Fine,20000000,9208876,9208876,-10791124,-0.539556
8/16/2019,Where’d You Go Bernadette,20000000,9198356,10840632,-9159368,-0.457968
8/27/2004,Superbabies: Baby Geniuses 2,20000000,9109322,9355369,-10644631,-0.532232
9/20/2013,Battle of the Year,20000000,8888355,16723377,-3276623,-0.163831
4/15/2016,Ratchet and Clank,20000000,8813410,14365639,-5634361,-0.281718
8/17/2007,Death at a Funeral,20000000,8580428,47289148,27289148,1.36446
9/9/2005,The Man,20000000,8330720,10393696,-9606304,-0.480315
1/5/2007,Code Name: The Cleaner,20000000,8135024,8135024,-11864976,-0.593249
12/12/2014,Inherent Vice,20000000,8110975,14772346,-5227654,-0.261383
4/16/2004,Connie and Carla,20000000,8047525,9649039,-10350961,-0.517548
10/11/2013,Machete Kills,20000000,8008161,18273009,-1726991,-0.0863495
4/1/2069,Sweet Charity,20000000,8000000,8000000,-12000000,-0.6
2/24/2006,Doogal,20000000,7578946,28058652,8058652,0.402933
9/16/2005,Proof,20000000,7535331,8284331,-11715669,-0.585783
10/3/2008,An American Carol,20000000,7013191,7022183,-12977817,-0.648891
3/14/2003,Willard,20000000,6882696,6882696,-13117304,-0.655865
2/1/2008,Strange Wilderness,20000000,6575282,6947084,-13052916,-0.652646
4/24/2015,Little Boy,20000000,6485961,17769299,-2230701,-0.111535
12/17/1999,Topsy Turvy,20000000,6201757,7797344,-12202656,-0.610133
10/25/2012,Chasing Mavericks,20000000,6002756,8300821,-11699179,-0.584959
12/31/2014,A Most Violent Year,20000000,5749134,8869722,-11130278,-0.556514
11/23/2011,A Dangerous Method,20000000,5702083,14807531,-5192469,-0.259623
7/7/2006,A Scanner Darkly,20000000,5501616,7405084,-12594916,-0.629746
8/14/2009,Bandslam,20000000,5210988,12967829,-7032171,-0.351609
1/28/2005,Alone in the Dark,20000000,5178569,10588079,-9411921,-0.470596
10/29/2004,Birth,20000000,5005899,14603001,-5396999,-0.26985
8/26/2016,Hands of Stone,20000000,4712792,5031975,-14968025,-0.748401
5/3/2019,Tolkien,20000000,4535154,8967531,-11032469,-0.551623
10/24/2008,Passchendaele,20000000,4452423,4453327,-15546673,-0.777334
10/3/2008,Flash of Genius,20000000,4442377,4504111,-15495889,-0.774794
11/21/2007,I’m Not There,20000000,4017609,12397613,-7602387,-0.380119
4/4/2012,The Cold Light of Day,20000000,3763583,25361206,5361206,0.26806
5/15/2009,The Brothers Bloom,20000000,3531756,5531756,-14468244,-0.723412
10/24/2008,Synecdoche New York,20000000,3083538,4383538,-15616462,-0.780823
1/24/2020,The Last Full Measure,20000000,2949212,3321111,-16678889,-0.833944
10/12/2018,Suspiria,20000000,2483472,7023292,-12976708,-0.648835
11/3/2017,LBJ,20000000,2468683,2507181,-17492819,-0.874641
10/29/1999,Mononoke-hime,20000000,2374107,150345863,130345863,6.51729
3/19/2004,Bon Voyage,20000000,2353728,8359720,-11640280,-0.582014
11/13/2015,My All-American,20000000,2246000,2246000,-17754000,-0.8877
6/20/1980,Can't Stop the Music,20000000,2000000,2000000,-18000000,-0.9
5/5/2006,The Proposition,20000000,1903434,5313608,-14686392,-0.73432
8/22/2003,Marci X,20000000,1646664,1646664,-18353336,-0.917667
12/6/2002,Equilibrium,20000000,1190018,5345869,-14654131,-0.732707
4/29/2011,Dylan Dog: Dead of Night,20000000,1186538,6093725,-13906275,-0.695314
8/29/2012,The Oogieloves in the BIG Balloon Adventure,20000000,1065907,1065907,-18934093,-0.946705
5/23/2008,The Children of Huang Shi,20000000,1031872,8221700,-11778300,-0.588915
10/20/2000,The Yards,20000000,882710,2282710,-17717290,-0.885865
8/6/2010,Middle Men,20000000,754301,754301,-19245699,-0.962285
4/24/2017,Jìyì dàshī,20000000,587470,43888531,23888531,1.19443
12/3/2010,All Good Things,20000000,582024,873617,-19126383,-0.956319
11/12/2015,By the Sea,20000000,538460,3727746,-16272254,-0.813613
10/22/2004,Steamboy,20000000,468867,10468867,-9531133,-0.476557
4/22/2005,The Game of Their Lives,20000000,375474,375474,-19624526,-0.981226
9/11/1994,Rapa Nui,20000000,305070,305070,-19694930,-0.984746
12/10/2010,The Tempest,20000000,277943,277943,-19722057,-0.986103
3/7/2008,長江七號 (CJ7),20000000,206678,47300771,27300771,1.36504
9/18/2009,The Burning Plain,20000000,200730,1167092,-18832908,-0.941645
3/27/1998,Les Couloirs du temps: Les visiteurs 2,20000000,146072,26146072,6146072,0.307304
4/25/2003,People I Know,20000000,121972,5694213,-14305787,-0.715289
10/1/2015,Regression,20000000,55039,15824374,-4175626,-0.208781
,Admiral,20000000,0,38585047,18585047,0.929252
8/23/2012,Zambezia,20000000,0,34454336,14454336,0.722717
4/13/2010,Three Kingdoms: Resurrection of the Dragon,20000000,0,22139590,2139590,0.10698
3/31/2004,The Touch,20000000,0,5918742,-14081258,-0.704063
7/27/2018,Extinction,20000000,0,2360000,-17640000,-0.882
5/29/2015,Survivor,20000000,0,1703281,-18296719,-0.914836
11/11/2016,The History of Love,20000000,0,476624,-19523376,-0.976169
12/25/2007,Butterfly on a Wheel,20000000,0,0,-20000000,-1
8/29/2014,Dwegons and Leprechauns,20000000,0,0,-20000000,-1
7/22/2016,Fight Valley,20000000,0,0,-20000000,-1
,The Thousand Miles,20000000,0,0,-20000000,-1
7/13/2018,How It Ends,20000000,0,0,-20000000,-1
12/13/2018,Bird Box,19800000,0,0,-19800000,-1
8/21/2009,Der Baader Meinhof Komplex,19700000,476270,16498827,-3201173,-0.162496
12/1/2017,The Shape of Water,19500000,63859435,195790794,176290794,9.04055
11/23/2012,De rouille et d’os,19500000,2061449,29393634,9893634,0.507366
12/20/2006,The Painted Veil,19400000,8060487,15118795,-4281205,-0.220681
8/23/2013,The Frozen Ground,19200000,0,5617460,-13582540,-0.707424
7/29/2011,The Devil's Double,19100000,1361512,5965646,-13134354,-0.687663
7/3/1985,Back to the Future,19000000,212259762,385510205,366510205,19.29
11/9/1990,Dances with Wolves,19000000,184208842,424208805,405208805,21.3268
7/7/2000,Scary Movie,19000000,157019771,277200000,258200000,13.5895
6/24/2011,Bad Teacher,19000000,100292856,215448997,196448997,10.3394
8/10/2016,Sausage Party,19000000,97670358,141344255,122344255,6.43917
9/15/1989,Sea of Love,19000000,58571513,58571513,39571513,2.08271
1/10/2003,Just Married,19000000,56127162,101564935,82564935,4.34552
9/11/2009,I Can Do Bad All By Myself,19000000,51733921,51733921,32733921,1.72284
7/16/2004,A Cinderella Story,19000000,51438175,70112484,51112484,2.69013
5/23/1980,The Shining,19000000,44568631,45605374,26605374,1.40028
10/26/2001,Thirteen Ghosts,19000000,41867960,68467960,49467960,2.60358
10/29/1999,House on Haunted Hill,19000000,40846082,65090541,46090541,2.42582
2/26/2010,The Crazies,19000000,39123589,56445534,37445534,1.97082
1/16/2009,Notorious,19000000,36843682,44972183,25972183,1.36696
11/2/2018,Nobody’s Fool,19000000,31713110,32589493,13589493,0.715236
8/20/2010,The Switch,19000000,27758465,49858465,30858465,1.62413
1/8/2010,Leap Year,19000000,25918920,32618920,13618920,0.716785
11/8/2013,The Book Thief,19000000,21488481,76086711,57086711,3.00456
10/19/2007,Gone Baby Gone,19000000,20300218,34359030,15359030,0.80837
7/26/2000,Thomas and the Magic Railroad,19000000,15911332,15911332,-3088668,-0.162561
11/8/2062,Mutiny on The Bounty,19000000,13680000,13680000,-5320000,-0.28
2/24/2012,Gone,19000000,11682205,18100189,-899811,-0.0473585
7/27/2001,Sen to Chihiro no Kamikakushi,19000000,10049886,383895320,364895320,19.205
10/17/2008,Sex Drive,19000000,8402485,10412485,-8587515,-0.451974
1/9/1998,Firestorm,19000000,8123860,8123860,-10876140,-0.572428
3/4/2011,Take Me Home Tonight,19000000,6928068,7576604,-11423396,-0.601231
9/28/2012,Won't Back Down,19000000,5310554,5745503,-13254497,-0.697605
6/1/2018,Action Point,19000000,5059608,5103675,-13896325,-0.731386
1/1/2064,The Fall of the Roman Empire,19000000,4750000,4750000,-14250000,-0.75
1/1/1993,The Nutcracker,19000000,2119994,2119994,-16880006,-0.888421
12/13/2011,George Balanchine\'s The Nutcracker,19000000,2119994,2119994,-16880006,-0.888421
8/16/1996,Kansas City,19000000,1353824,1353824,-17646176,-0.928746
3/8/2016,Out of the Inferno,19000000,0,0,-19000000,-1
6/24/2005,George A. Romero's Land of the Dead,18975000,20700082,47751015,28776015,1.51652
12/15/2006,Indigènes,18900000,320700,26063572,7163572,0.379025
4/15/2005,The Amityville Horror,18500000,65233369,109175673,90675673,4.90139
12/6/2002,Adaptation,18500000,22498520,32531759,14031759,0.758473
10/2/2009,The Invention of Lying,18500000,18451251,32714818,14214818,0.768369
5/22/1998,Fear and Loathing in Las Vegas,18500000,10680275,13711903,-4788097,-0.258816
7/4/2008,Ne le dis à personne,18500000,6198883,33954018,15454018,0.835352
2/2/2001,Left Behind,18500000,4221341,4221341,-14278659,-0.771819
3/12/2020,The Hunt,18200000,5812500,12400979,-5799021,-0.318628
5/9/2014,Neighbors,18000000,150086800,270944428,252944428,14.0525
11/3/2006,Borat,18000000,128505958,261443242,243443242,13.5246
7/29/1994,The Mask,18000000,119920129,351620129,333620129,18.5345
6/3/1988,Big,18000000,114968774,151665347,133665347,7.42585
7/13/2001,Legally Blonde,18000000,96493426,141809235,123809235,6.87829
4/30/2004,Mean Girls,18000000,86047227,130714469,112714469,6.26191
6/1/1984,Star Trek III: The Search for Spock,18000000,76471046,87000000,69000000,3.83333
9/9/2005,The Exorcism of Emily Rose,18000000,75072454,144529078,126529078,7.02939
12/10/1999,Deuce Bigalow: Male Gigolo,18000000,65535067,92935067,74935067,4.16306
2/6/2004,Barbershop 2: Back in Business,18000000,65070412,65842412,47842412,2.65791
12/16/2005,The Family Stone,18000000,60062868,92357499,74357499,4.13097
11/26/2003,Bad Santa,18000000,60060328,77147031,59147031,3.28595
6/12/1987,Predator,18000000,59735548,98267558,80267558,4.45931
3/23/2016,My Big Fat Greek Wedding 2,18000000,59689605,92096558,74096558,4.11648
9/9/2015,The Perfect Guy,18000000,57027435,60278166,42278166,2.34879
5/2/1997,Austin Powers: International Man of Mystery,18000000,53883989,67683989,49683989,2.76022
3/25/2011,Diary of a Wimpy Kid: Rodrick Rules,18000000,52698535,73695194,55695194,3.09418
9/19/1984,Amadeus,18000000,51973029,51973029,33973029,1.88739
7/1/2021,The Forever Purge,18000000,44539245,76994245,58994245,3.27746
4/11/2008,Prom Night,18000000,43869350,57193655,39193655,2.17743
4/8/2011,Soul Surfer,18000000,43853424,47158652,29158652,1.61993
9/26/2003,Under the Tuscan Sun,18000000,43601508,57490024,39490024,2.19389
6/27/2018,Uncle Drew,18000000,42469946,46594261,28594261,1.58857
10/17/2014,Birdman or (The Unexpected Virtue of Ignorance),18000000,42340598,103215094,85215094,4.73417
10/10/1986,Peggy Sue Got Married,18000000,41382841,41382841,23382841,1.29905
12/26/2001,Gosford Park,18000000,41300105,58271886,40271886,2.23733
1/11/2002,Orange County,18000000,41059716,43308707,25308707,1.40604
3/14/1986,Gung Ho,18000000,36611610,36611610,18611610,1.03398
7/26/2013,Blue Jasmine,18000000,33404871,102912961,84912961,4.71739
4/28/2006,United 93,18000000,31567134,77635035,59635035,3.31306
12/5/2003,Honey,18000000,30272254,62646763,44646763,2.48038
10/14/2005,The Fog,18000000,29511112,37048526,19048526,1.05825
5/24/1996,Spy Hard,18000000,26936265,26936265,8936265,0.496459
8/7/2015,Ricki and the Flash,18000000,26839498,41166033,23166033,1.287
12/13/1989,Glory,18000000,26828365,26828365,8828365,0.490465
8/9/2019,The Art of Racing in the Rain,18000000,26402818,30997027,12997027,0.722057
6/29/1984,Conan the Destroyer,18000000,26400000,26400000,8400000,0.466667
11/12/2015,Love the Coopers,18000000,26302731,44263413,26263413,1.45908
6/24/2070,Catch-22,18000000,24911670,24911670,6911670,0.383982
4/10/2009,Observe and Report,18000000,24007324,27148898,9148898,0.508272
11/14/1980,Raging Bull,18000000,23380203,23380513,5380513,0.298917
9/18/2009,Love Happens,18000000,22965110,36133014,18133014,1.00739
9/25/2009,Fame,18000000,22455510,80227619,62227619,3.45709
4/28/2017,The Circle,18000000,20497844,40651864,22651864,1.25844
12/4/1985,Young Sherlock Holmes,18000000,19739000,19739000,1739000,0.0966111
11/5/2010,127 Hours,18000000,18335230,60217171,42217171,2.3454
5/19/2000,Small Time Crooks,18000000,17266359,29934477,11934477,0.663026
5/12/2000,Center Stage,18000000,17200925,21361109,3361109,0.186728
1/14/2016,Norm of the North,18000000,17062499,30535660,12535660,0.696426
2/6/2004,Catch That Kid,18000000,16703799,16959614,-1040386,-0.0577992
8/16/2013,Jobs,18000000,16131410,43402515,25402515,1.41125
10/26/2001,Life as a House,18000000,15652637,23889158,5889158,0.327175
1/8/2010,Youth in Revolt,18000000,15285588,19685588,1685588,0.0936438
7/10/2014,And So It Goes,18000000,15160801,17920013,-79987,-0.00444372
7/10/2009,I Love You Beth Cooper,18000000,14800725,16382538,-1617462,-0.089859
7/24/1981,Blow Out,18000000,13747234,13747988,-4252012,-0.236223
3/30/2001,The Tailor of Panama,18000000,13491653,27491653,9491653,0.527314
5/22/1981,The Legend of the Lone Ranger,18000000,13400000,13400000,-4600000,-0.255556
1/31/2014,Labor Day,18000000,13371528,14189810,-3810190,-0.211677
8/30/2013,Getaway,18000000,10501938,11813989,-6186011,-0.343667
9/26/1997,The Ice Storm,18000000,8038061,16011975,-1988025,-0.110446
10/15/2004,Being Julia,18000000,7739049,14451322,-3548678,-0.197149
3/22/1989,Troop Beverly Hills,18000000,7190505,7190505,-10809495,-0.600527
2/21/1986,Nine 1/2 Weeks,18000000,6734844,6734844,-11265156,-0.625842
1/15/2010,The Last Station,18000000,6617867,15696146,-2303854,-0.127992
6/26/1981,Dragonslayer,18000000,6000000,6000000,-12000000,-0.666667
9/30/1994,Ed Wood,18000000,5828466,5828734,-12171266,-0.676181
6/6/2008,Mongol,18000000,5705761,27147349,9147349,0.508186
10/8/2008,RocknRolla,18000000,5700626,27794339,9794339,0.54413
6/25/1982,Megaforce,18000000,5675599,5675599,-12324401,-0.684689
8/20/2010,Mao's Last Dancer,18000000,4806750,25941437,7941437,0.441191
12/25/1996,Hamlet,18000000,4501094,7129670,-10870330,-0.603907
4/11/2014,The Railway Man,18000000,4438438,23910210,5910210,0.328345
12/29/1995,Restoration,18000000,4100000,4100000,-13900000,-0.772222
2/18/2016,Midnight Special,18000000,3712282,7680250,-10319750,-0.573319
11/25/2016,Miss Sloane,18000000,3500605,7768259,-10231741,-0.56843
9/27/2013,Metallica Through the Never,18000000,3419967,9082906,-8917094,-0.495394
9/19/2003,Anything Else,18000000,3203044,13203044,-4796956,-0.266498
2/23/1996,Unforgettable,18000000,2483790,2483790,-15516210,-0.862012
1/27/2017,T2: Trainspotting,18000000,2402004,42137612,24137612,1.34098
12/30/2009,Das Weisse Band: Eine deutsche Kindergeschichte,18000000,2222862,25727044,7727044,0.42928
4/25/1986,8 Million Ways to Die,18000000,1305114,1305114,-16694886,-0.927494
3/1/2013,Phantom,18000000,1034589,1199510,-16800490,-0.933361
4/26/2002,The Salton Sea,18000000,676698,676698,-17323302,-0.962406
4/24/2009,The Informers,18000000,315000,315000,-17685000,-0.9825
9/24/1999,One Man's Hero,18000000,229311,229311,-17770689,-0.98726
10/15/2010,Carlos,18000000,145526,1619153,-16380847,-0.910047
9/22/2006,Renaissance,18000000,70644,2401413,-15598587,-0.866588
7/9/2002,My Spy,18000000,0,6983461,-11016539,-0.61203
,I Come with the Rain,18000000,0,627422,-17372578,-0.965143
4/14/2016,I Am Wrath,18000000,0,309608,-17690392,-0.9828
11/14/2014,Wolves,18000000,0,94953,-17905047,-0.994725
4/8/2008,Day of the Dead,18000000,0,0,-18000000,-1
8/22/2014,The Prince,18000000,0,0,-18000000,-1
2/19/2016,Forsaken,18000000,0,0,-18000000,-1
6/28/1985,Red Sonja,17900000,6905861,6908640,-10991360,-0.614042
12/19/2019,Baekdusan,17700000,372562,59505509,41805509,2.36189
7/13/2012,Red Lights,17700000,49521,14518884,-3181116,-0.179724
8/17/2007,Superbad,17500000,121463226,169955142,152455142,8.71172
2/20/2009,Madea Goes To Jail,17500000,90508336,90508336,73008336,4.1719
2/14/2008,Step Up 2 the Streets,17500000,58017783,148586910,131086910,7.49068
1/13/2006,Hoodwinked,17500000,51386611,109843390,92343390,5.27677
12/22/2004,Hotel Rwanda,17500000,23519128,36520451,19020451,1.08688
8/25/2006,Beerfest,17500000,19185184,20159316,2659316,0.151961
11/27/2013,Black Nativity,17500000,7018188,7454184,-10045816,-0.574047
4/25/2003,City of Ghosts,17500000,325491,325491,-17174509,-0.981401
,Taxi 4,17500000,0,60865364,43365364,2.47802
2/22/2019,Hotel Mumbai,17300000,9619500,21132855,3832855,0.221552
4/4/2018,A Quiet Place,17000000,188024361,334876670,317876670,18.6986
8/10/2001,The Others,17000000,96522687,207765056,190765056,11.2215
7/18/1986,Aliens,17000000,85160248,183300764,166300764,9.7824
8/13/2014,Let’s Be Cops,17000000,82390774,136890774,119890774,7.0524
10/17/1997,I Know What You Did Last Summer,17000000,72250091,125250091,108250091,6.36765
10/22/2064,My Fair Lady,17000000,72000000,72071636,55071636,3.23951
10/22/2004,Sideways,17000000,71502303,109726800,92726800,5.45452
11/15/2013,The Best Man Holiday,17000000,70525195,72835710,55835710,3.28445
2/13/2009,Friday the 13th,17000000,65002019,92670237,75670237,4.45119
9/28/2012,Pitch Perfect,17000000,65001093,116044347,99044347,5.82614
8/5/1998,Halloween: H2O,17000000,55041738,55041738,38041738,2.23775
4/3/2013,Evil Dead,17000000,54239856,99041947,82041947,4.826
8/27/2004,Jet Li's Hero,17000000,53652140,177535958,160535958,9.44329
10/29/2010,Saw 3D,17000000,45710178,133735284,116735284,6.86678
2/20/2015,McFarland USA,17000000,44480275,45707924,28707924,1.6887
11/1/2019,Harriet,17000000,43082155,43248374,26248374,1.54402
11/11/2016,Almost Christmas,17000000,42065185,42493506,25493506,1.49962
3/10/2006,The Hills Have Eyes,17000000,41778863,70355813,53355813,3.13858
7/11/2019,Crawl,17000000,39014193,90007532,73007532,4.29456
3/1/2002,40 Days and 40 Nights,17000000,37939782,95092667,78092667,4.59369
10/10/2003,Good Boy!,17000000,37667746,45312217,28312217,1.66542
1/26/2007,Smokin' Aces,17000000,35662731,57263440,40263440,2.36844
10/2/1998,A Night at the Roxbury,17000000,30331165,30331165,13331165,0.784186
3/4/2011,Beastly,17000000,27865571,38028230,21028230,1.23695
3/5/2010,Brooklyn's Finest,17000000,27163593,39233233,22233233,1.30784
7/9/1982,Tron,17000000,26918576,26919100,9919100,0.583476
8/20/2010,Lottery Ticket,17000000,24719879,24719879,7719879,0.454111
9/5/2003,Dickie Roberts: Former Child Star,17000000,22734486,23734486,6734486,0.396146
3/31/2006,ATL,17000000,21170563,21170563,4170563,0.245327
8/24/2001,Summer Catch,17000000,19693891,19693891,2693891,0.158464
12/11/1998,A Simple Plan,17000000,16316273,16316273,-683727,-0.0402192
3/24/2006,Larry the Cable Guy: Health Inspector,17000000,15680099,15680099,-1319901,-0.0776412
7/24/1987,Superman IV: The Quest for Peace,17000000,14522355,36700000,19700000,1.15882
11/27/2002,They,17000000,12840842,16140842,-859158,-0.0505387
10/1/1999,The Adventures of Elmo in Grouchland,17000000,11634458,11634458,-5365542,-0.31562
5/29/2063,55 Days at Peking,17000000,10000000,10000000,-7000000,-0.411765
6/5/2009,My Life in Ruins,17000000,8677425,20477425,3477425,0.204554
4/21/2006,American Dreamz,17000000,7314027,16510971,-489029,-0.0287664
1/25/2008,How She Move,17000000,7070641,8607815,-8392185,-0.493658
2/24/2006,Running Scared,17000000,6855137,9729088,-7270912,-0.427701
8/23/2012,The Apparition,17000000,4936819,10637281,-6362719,-0.374278
4/30/2004,Bobby Jones: Stroke of Genius,17000000,2694071,2694071,-14305929,-0.841525
8/29/1986,Shanghai Surprise,17000000,2315000,2315000,-14685000,-0.863824
12/25/2010,L'illusionniste,17000000,2231474,8609949,-8390051,-0.493532
1/1/1981,Roar,17000000,2110050,2110050,-14889950,-0.875879
7/11/2003,Veronica Guerin,17000000,1569918,9438074,-7561926,-0.444819
6/10/2016,Genius,17000000,1361045,7265283,-9734717,-0.57263
3/15/2019,Nancy Drew and the Hidden Staircase,17000000,623088,624531,-16375469,-0.963263
11/14/2007,Southland Tales,17000000,275380,364607,-16635393,-0.978553
1/16/2015,Escobar: Paradise Lost,17000000,195792,3917679,-13082321,-0.769548
2/6/2015,Mune le gardien de la lune,17000000,0,14534046,-2465954,-0.145056
6/23/2009,Chasseurs de dragons,17000000,0,13446115,-3553885,-0.209052
10/21/1977,Damnation Alley,17000000,0,0,-17000000,-1
3/10/2016,The Young Messiah,16800000,6469813,7313697,-9486303,-0.564661
11/10/2006,FUR: An Imaginary Portrait of Diane Arbus,16800000,223202,2281089,-14518911,-0.864221
11/27/1991,My Girl,16500000,58011485,58011485,41511485,2.51585
12/11/1987,Wall Street,16500000,43848100,43848100,27348100,1.65746
12/11/1995,Sense and Sensibility,16500000,42993774,134993774,118493774,7.18144
8/18/2006,The Illusionist,16500000,39868642,83792062,67292062,4.07831
8/3/2007,Becoming Jane,16500000,18663911,39380831,22880831,1.38672
12/19/2003,House of Sand and Fog,16500000,13005485,16154786,-345214,-0.0209221
9/21/2007,Sydney White,16500000,11892415,13636339,-2863661,-0.173555
,Arn - Tempelriddaren,16500000,0,21404122,4904122,0.29722
10/17/2018,Le Flic de Belleville,16500000,0,8126380,-8373620,-0.507492
6/2/1989,Dead Poets Society,16400000,95860116,239500000,223100000,13.6037
11/6/2017,Gatwick Gangsters,16066830,0,0,-16066830,-1
12/16/1994,Dumb & Dumber,16000000,127175374,246400000,230400000,14.4
7/14/1989,When Harry Met Sally…,16000000,92823546,92999400,76999400,4.81246
5/19/2000,Road Trip,16000000,68525609,119739110,103739110,6.48369
12/8/1982,The Verdict,16000000,53977250,53977250,37977250,2.37358
1/15/1999,Varsity Blues,16000000,52894169,54294169,38294169,2.39339
5/16/2012,Moonrise Kingdom,16000000,45512466,68848446,52848446,3.30303
10/12/2011,The Artist,16000000,44667095,128256712,112256712,7.01604
1/9/2009,The Unborn,16000000,42670410,78208812,62208812,3.88805
8/2/2002,The Master of Disguise,16000000,40363530,40363530,24363530,1.52272
10/6/2006,The Texas Chainsaw Massacre: The Beginning,16000000,39517763,50517763,34517763,2.15736
11/30/2006,El Laberinto del Fauno,16000000,37634615,87041569,71041569,4.4401
2/4/2011,The Roommate,16000000,37300107,52545707,36545707,2.28411
2/2/2007,The Messengers,16000000,35374833,53774833,37774833,2.36093
11/2/1984,The Killing Fields,16000000,34609720,34609720,18609720,1.16311
3/2/2001,See Spot Run,16000000,33357476,43057552,27057552,1.6911
8/9/1991,Double Impact,16000000,29090445,29090445,13090445,0.818153
6/27/2001,Baby Boy,16000000,28734552,28734552,12734552,0.79591
3/19/2021,Nobody,16000000,27268035,57210518,41210518,2.57566
4/11/2001,Joe Dirt,16000000,27087695,30987695,14987695,0.936731
9/12/2008,The Women,16000000,26902075,50103808,34103808,2.13149
2/16/2007,Hot Fuzz,16000000,23618786,81742618,65742618,4.10891
8/15/2008,Vicky Cristina Barcelona,16000000,23216709,104504817,88504817,5.53155
5/3/2019,A Dog’s Journey,16000000,22782371,78870908,62870908,3.92943
7/11/2019,Stuber,16000000,22370452,29634769,13634769,0.852173
6/16/2000,Boys and Girls,16000000,21799652,21799652,5799652,0.362478
6/13/2018,Superfly,16000000,20537137,20739323,4739323,0.296208
11/18/1994,Léon,16000000,19284974,45284974,29284974,1.83031
3/12/2010,Remember Me,16000000,19068240,56506120,40506120,2.53163
10/11/2002,White Oleander,16000000,16357770,21657770,5657770,0.353611
9/18/2009,Jennifer's Body,16000000,16204793,31943401,15943401,0.996463
3/3/2000,Drowning Mona,16000000,15427192,15980376,-19624,-0.0012265
1/30/1987,Radio Days,16000000,14792779,14792779,-1207221,-0.0754513
7/18/2003,How to Deal,16000000,14108518,14125516,-1874484,-0.117155
10/3/2014,Left Behind,16000000,14019924,20769209,4769209,0.298076
5/28/2004,Soul Plane,16000000,13922211,14553807,-1446193,-0.0903871
12/9/1988,My Stepmother Is an Alien,16000000,13854000,13854000,-2146000,-0.134125
6/29/2012,People Like Us,16000000,12431792,12617472,-3382528,-0.211408
5/28/1999,The Thirteenth Floor,16000000,11810854,11810854,-4189146,-0.261822
9/3/2004,The Cookout,16000000,11540112,11540112,-4459888,-0.278743
10/19/1979,Meteor,16000000,8400000,8400000,-7600000,-0.475
3/7/1986,Highlander,16000000,5900000,12900000,-3100000,-0.19375
11/18/2016,Bleed for This,16000000,5083906,7171320,-8828680,-0.551793
5/3/2002,Hollywood Ending,16000000,4839383,14839383,-1160617,-0.0725386
9/15/2000,Duets,16000000,4734235,6615452,-9384548,-0.586534
8/13/1999,Detroit Rock City,16000000,4217115,5825314,-10174686,-0.635918
10/19/2007,Things We Lost in the Fire,16000000,3287315,8120148,-7879852,-0.492491
6/4/2014,The Homesman,16000000,2429989,8217571,-7782429,-0.486402
3/27/2013,Trance,16000000,2322593,22594052,6594052,0.412128
5/16/2014,The Immigrant,16000000,2013456,7585011,-8414989,-0.525937
8/15/1997,Steel,16000000,1686429,1686429,-14313571,-0.894598
12/21/2005,The White Countess,16000000,1669971,2814566,-13185434,-0.82409
7/25/2008,Bienvenue chez les Ch'tis,16000000,1477650,247474497,231474497,14.4672
7/15/2020,Ban-do,16000000,1224525,35077947,19077947,1.19237
10/1/2014,Men Women and Children,16000000,705908,1685403,-14314597,-0.894662
4/12/2019,Teen Spirit,16000000,441366,1573603,-14426397,-0.90165
9/24/2010,Enter the Void,16000000,337997,1467278,-14532722,-0.908295
12/31/2008,Good,16000000,31631,31631,-15968369,-0.998023
11/2/2012,Vamps,16000000,3361,94812,-15905188,-0.994074
5/11/2010,Haeundae,16000000,0,64733391,48733391,3.04584
3/9/2010,Hachiko: A Dog’s Story,16000000,0,47707417,31707417,1.98171
12/4/2013,Zulu,16000000,0,1844228,-14155772,-0.884736
5/22/2020,The Lovebirds,16000000,0,0,-16000000,-1
9/28/2018,The Old Man and the Gun,15800000,11277120,16955673,1155673,0.0731439
10/16/2020,Kimetsu no Yaiba: Mugen Ressha-Hen,15765750,47700000,503063688,487297938,30.9086
12/7/2018,Second Act,15700000,39282227,63288854,47588854,3.03114
6/21/2002,Juwanna Mann,15600000,13571817,13771817,-1828183,-0.117191
1/24/2020,The Personal History of David Copperfield,15600000,1876298,13211271,-2388729,-0.153124
6/8/2007,La Môme,15500000,10299782,88611837,73111837,4.71689
11/15/2002,Ararat,15500000,1693000,1757694,-13742306,-0.8866
4/13/2007,Slow Burn,15500000,1237615,1237615,-14262385,-0.920154
4/22/2005,Madison,15500000,517262,517262,-14982738,-0.966628
2/26/2010,The Yellow Handkerchief,15500000,318623,318623,-15181377,-0.979444
7/7/2021,Annette,15500000,0,3297276,-12202724,-0.787273
5/1/2015,Far from the Madding Crowd,15495600,12236500,29729450,14233850,0.918574
9/27/2002,Wasabi,15300000,81525,7000000,-8300000,-0.542484
3/31/2006,Slither,15250000,7802450,12930343,-2319657,-0.152109
11/16/1990,Home Alone,15000000,285761243,476684675,461684675,30.779
12/5/1984,Beverly Hills Cop,15000000,234760478,316300000,301300000,20.0867
5/16/1986,Top Gun,15000000,180012912,357011945,342011945,22.8008
12/17/1982,Tootsie,15000000,177200000,177200000,162200000,10.8133
11/25/1987,3 Men and a Baby,15000000,167780960,167780960,152780960,10.1854
11/26/2010,The King’s Speech,15000000,138797449,430061213,415061213,27.6707
9/15/1999,American Beauty,15000000,130058047,356258047,341258047,22.7505
12/8/2000,Crouching Tiger Hidden Dragon,15000000,128067808,213514672,198514672,13.2343
12/9/1988,Twins,15000000,111936388,216600000,201600000,13.44
12/20/1996,Scream,15000000,103046663,173046663,158046663,10.5364
8/2/2017,Annabelle: Creation,15000000,102092201,305384865,290384865,19.359
10/23/2013,Jackass Presents: Bad Grandpa,15000000,102003019,160903019,145903019,9.72687
6/28/1978,Heaven Can Wait,15000000,98800000,98800000,83800000,5.58667
12/18/1985,The Color Purple,15000000,94029472,94029472,79029472,5.26863
11/14/2014,The Imitation Game,15000000,91125143,227328585,212328585,14.1552
3/30/1988,Beetlejuice,15000000,73839613,74456266,59456266,3.96375
11/18/2059,Ben-Hur,15000000,73000000,73259017,58259017,3.88393
1/4/2016,10 Cloverfield Lane,15000000,72082999,108286422,93286422,6.21909
1/17/2013,Mama,15000000,71628180,148095566,133095566,8.87304
10/10/1980,Private Benjamin,15000000,69847348,69847348,54847348,3.65649
3/7/1980,Coal Miner’s Daughter,15000000,67182787,67182787,52182787,3.47885
3/6/1987,Lethal Weapon,15000000,65192350,120192350,105192350,7.01282
3/19/2010,Diary of a Wimpy Kid,15000000,64003625,76954311,61954311,4.13029
7/29/1983,National Lampoon’s Vacation,15000000,61400000,61400000,46400000,3.09333
8/31/2007,Halloween,15000000,58269151,77514401,62514401,4.16763
9/15/2006,The Queen,15000000,56441711,128885873,113885873,7.59239
10/12/2007,Why Did I Get Married?,15000000,55204525,55934178,40934178,2.72895
2/3/2012,The Woman in Black,15000000,54333290,128955898,113955898,7.59706
12/21/1994,Little Women,15000000,50003303,50003303,35003303,2.33355
1/1/1979,The Deer Hunter,15000000,50000000,50057795,35057795,2.33719
8/9/2018,BlacKkKlansman,15000000,49275340,93411426,78411426,5.22743
2/3/2006,When a Stranger Calls,15000000,47860214,67215435,52215435,3.48103
2/8/2002,Big Fat Liar,15000000,47811275,52461017,37461017,2.4974
8/15/1997,Cop Land,15000000,44906632,63706632,48706632,3.24711
12/25/1997,Wag the Dog,15000000,43057470,64252038,49252038,3.28347
2/21/2013,Snitch,15000000,42930462,57907734,42907734,2.86052
5/2/2003,The Lizzie McGuire Movie,15000000,42734455,55534455,40534455,2.7023
12/2/2015,Krampus,15000000,42725475,61788393,46788393,3.11923
9/20/2012,End of Watch,15000000,41003371,57586606,42586606,2.83911
12/25/1998,The Faculty,15000000,40283321,40283321,25283321,1.68555
6/9/1993,What's Love Got to Do With It,15000000,39100956,39100956,24100956,1.60673
12/14/2001,Not Another Teen Movie,15000000,37882551,62401343,47401343,3.16009
12/3/2014,Wild,15000000,37880356,52460543,37460543,2.49737
12/16/2062,Lawrence of Arabia,15000000,37495385,69995047,54995047,3.66634
11/7/2014,The Theory of Everything,15000000,35893537,123327692,108327692,7.22185
9/16/2011,Drive,15000000,35060689,81357930,66357930,4.42386
3/31/2000,The Skulls,15000000,35007180,35007180,20007180,1.33381
10/10/2066,Hawaii,15000000,34562222,34562222,19562222,1.30415
11/23/2018,The Favourite,15000000,34366783,95872148,80872148,5.39148
4/18/2003,Malibu's Most Wanted,15000000,34308901,34499204,19499204,1.29995
9/4/2009,All About Steve,15000000,33862903,40127259,25127259,1.67515
4/28/2000,Where the Heart Is,15000000,33771174,40862054,25862054,1.72414
8/28/2009,Halloween 2,15000000,33392973,38512850,23512850,1.56752
3/13/2009,The Last House on the Left,15000000,32752215,46526243,31526243,2.10175
2/18/2005,Because of Winn-Dixie,15000000,32647042,33508485,18508485,1.2339
8/12/2021,Don’t Breathe 2,15000000,32638038,47227560,32227560,2.1485
2/4/2005,The Wedding Date,15000000,31726995,47175038,32175038,2.145
9/25/1987,The Princess Bride,15000000,30857000,31045750,16045750,1.06972
7/12/2002,Halloween: Resurrection,15000000,30259652,37659652,22659652,1.51064
12/25/2007,The Great Debaters,15000000,30226144,30261293,15261293,1.01742
8/22/2014,When the Game Stands Tall,15000000,30127963,30138912,15138912,1.00926
6/12/1981,Clash of the Titans,15000000,30000000,44400000,29400000,1.96
2/20/2004,Confessions of a Teenage Drama Queen,15000000,29331068,33118854,18118854,1.20792
4/17/1998,The Object of my Affection,15000000,29145924,29145924,14145924,0.943062
5/11/2007,28 Weeks Later,15000000,28638916,64232714,49232714,3.28218
4/11/1997,Grosse Pointe Blank,15000000,28084357,31070412,16070412,1.07136
4/21/2000,Love & Basketball,15000000,27441122,27709625,12709625,0.847308
9/8/2017,Home Again,15000000,27020284,37336874,22336874,1.48912
10/27/2000,Book of Shadows: Blair Witch 2,15000000,26421314,47721314,32721314,2.18142
10/10/1997,Boogie Nights,15000000,26410771,43111725,28111725,1.87411
7/23/2010,Ramona and Beezus,15000000,26167002,27469621,12469621,0.831308
7/1/2021,Escape Room: Tournament of Champions,15000000,25188958,51788711,36788711,2.45258
8/27/2014,The November Man,15000000,25018119,34820335,19820335,1.32136
5/3/1996,The Craft,15000000,24769466,55669466,40669466,2.7113
12/28/2005,Match Point,15000000,23089926,87950928,72950928,4.8634
11/5/1993,The Remains of the Day,15000000,22954968,63954968,48954968,3.26366
1/15/1993,Nowhere to Run,15000000,22189039,52189039,37189039,2.47927
9/22/2000,Urban Legends: Final Cut,15000000,21468807,38574362,23574362,1.57162
3/20/2013,The Place Beyond the Pines,15000000,21403519,47011449,32011449,2.1341
10/20/2006,Flicka,15000000,21000147,21896367,6896367,0.459758
3/23/2007,The Hills Have Eyes II,15000000,20804166,37466538,22466538,1.49777
4/29/2016,Keanu,15000000,20591853,20688141,5688141,0.379209
2/14/2020,The Photograph,15000000,20578185,20704381,5704381,0.380292
12/22/2010,Country Strong,15000000,20218921,20601987,5601987,0.373466
10/11/2002,Tuck Everlasting,15000000,19161999,19344615,4344615,0.289641
10/13/2006,The Marine,15000000,18844784,22165608,7165608,0.477707
7/24/1998,Disturbing Behavior,15000000,17507368,19014238,4014238,0.267616
3/6/1998,The Big Lebowski,15000000,17498804,46189568,31189568,2.0793
7/25/2014,A Most Wanted Man,15000000,17237855,36068890,21068890,1.40459
6/26/2009,The Hurt Locker,15000000,17017811,49876984,34876984,2.32513
1/28/2000,Eye of the Beholder,15000000,16500786,18260865,3260865,0.217391
11/2/2012,The Man with the Iron Fists,15000000,15634090,22018988,7018988,0.467933
5/11/1984,Firestarter,15000000,15136870,15136870,136870,0.00912467
1/30/2019,Miss Bala,15000000,14998027,15364632,364632,0.0243088
9/21/2012,Killing Them Softly,15000000,14945541,39238443,24238443,1.6159
4/20/2001,Freddy Got Fingered,15000000,14249005,14249005,-750995,-0.0500663
6/23/2011,One Day,15000000,13843771,59168692,44168692,2.94458
6/25/2004,De-Lovely,15000000,13337299,18524496,3524496,0.234966
10/2/2009,Whip It,15000000,13077184,18889972,3889972,0.259331
1/11/2008,The Pirates Who Don't Do Anything: A VeggieTale…,15000000,12981269,13248444,-1751556,-0.11677
1/23/2008,U2 3D,15000000,12898847,26170402,11170402,0.744693
9/1/2000,Highlander: Endgame,15000000,12801190,12801190,-2198810,-0.146587
11/25/2016,The Founder,15000000,12786053,24403192,9403192,0.626879
8/25/2006,Idlewild,15000000,12669914,12669914,-2330086,-0.155339
4/25/2003,Confidence,15000000,12212417,12970401,-2029599,-0.135307
8/9/2019,Blinded by the Light,15000000,11901145,18144644,3144644,0.209643
10/11/2002,Knockaround Guys,15000000,11660180,12419700,-2580300,-0.17202
8/27/1999,The Muse,15000000,11614954,11614954,-3385046,-0.22567
4/3/1998,Barney's Great Adventure,15000000,11156471,11156471,-3843529,-0.256235
3/1/1989,New York Stories,15000000,10763469,10763469,-4236531,-0.282435
11/25/1998,Home Fries,15000000,10513979,10513979,-4486021,-0.299068
3/24/2000,Here on Earth,15000000,10494147,10845127,-4154873,-0.276992
10/8/2004,Raise Your Voice,15000000,10411980,14811980,-188020,-0.0125347
5/31/1985,Brazil,15000000,9929135,9934482,-5065518,-0.337701
4/23/1993,The Dark Half,15000000,9579068,9579068,-5420932,-0.361395
3/2/2007,Black Snake Moan,15000000,9396870,10951153,-4048847,-0.269923
2/21/2003,Dark Blue,15000000,9237470,12262065,-2737935,-0.182529
6/22/2007,A Mighty Heart,15000000,9176787,19153568,4153568,0.276905
9/30/1983,Brainstorm,15000000,8921050,8921050,-6078950,-0.405263
9/23/2016,Queen of Katwe,15000000,8874389,10055481,-4944519,-0.329635
3/24/2000,Whatever it Takes,15000000,8735529,8735529,-6264471,-0.417631
3/21/2003,Boat Trip,15000000,8586376,14933713,-66287,-0.00441913
5/22/2002,The Importance of Being Earnest,15000000,8378141,8667209,-6332791,-0.422186
5/21/1999,The Love Letter,15000000,8322608,9203182,-5796818,-0.386455
5/5/2006,Hoot,15000000,8117637,8224998,-6775002,-0.451667
11/6/2015,Trumbo,15000000,7857741,13300181,-1699819,-0.113321
2/8/2008,In Bruges,15000000,7800825,34533783,19533783,1.30225
1/4/2013,Promised Land,15000000,7597898,12394562,-2605438,-0.173696
10/8/2001,Mulholland Drive,15000000,7219578,20780568,5780568,0.385371
6/7/2018,Hotel Artemis,15000000,6708137,13316627,-1683373,-0.112225
8/20/2008,The Rocker,15000000,6409528,8767338,-6232662,-0.415511
8/21/2009,Post Grad,15000000,6382178,6563402,-8436598,-0.56244
6/19/2009,Whatever Works,15000000,5306706,35106706,20106706,1.34045
7/19/2000,The In Crowd,15000000,5217498,5217498,-9782502,-0.652167
12/14/2005,Los tres entierros de Melquiades Estrada,15000000,5027684,13454474,-1545526,-0.103035
9/24/1999,Jakob the Liar,15000000,4956401,4956401,-10043599,-0.669573
9/28/2007,Se jie,15000000,4604982,65167430,50167430,3.3445
1/21/2011,The Company Men,15000000,4444612,4569967,-10430033,-0.695336
10/21/2005,Kiss Kiss Bang Bang,15000000,4235837,16829464,1829464,0.121964
4/30/1999,Idle Hands,15000000,4023741,4024142,-10975858,-0.731724
10/29/2015,Scouts Guide to the Zombie Apocalypse,15000000,3703046,15554855,554855,0.0369903
1/26/2007,Blood and Chocolate,15000000,3526588,6551310,-8448690,-0.563246
9/22/2010,You Will Meet a Tall Dark Stranger,15000000,3247816,38535748,23535748,1.56905
10/23/2015,Rock the Kasbah,15000000,3020665,3386153,-11613847,-0.774256
12/4/2015,Chi-raq,15000000,2653031,2733397,-12266603,-0.817774
9/15/2010,Never Let Me Go,15000000,2434652,11173718,-3826282,-0.255085
9/9/2016,The Disappointments Room,15000000,2423467,3503761,-11496239,-0.766416
12/25/2003,The Company,15000000,2281585,3393606,-11606394,-0.77376
7/18/2008,Transsiberian,15000000,2203641,6379575,-8620425,-0.574695
10/22/1999,Crazy in Alabama,15000000,1954202,1954202,-13045798,-0.86972
1/17/1986,The Clan of the Cave Bear,15000000,1953732,1953732,-13046268,-0.869751
2/3/2017,The Comedian,15000000,1658706,1658706,-13341294,-0.88942
3/14/2008,Funny Games,15000000,1294640,8200127,-6799873,-0.453325
6/2/2006,Banlieue 13,15000000,1200216,11599903,-3400097,-0.226673
11/12/1999,Felicia's Journey,15000000,824295,1970268,-13029732,-0.868649
1/1/2002,Metropolis,15000000,673414,1405032,-13594968,-0.906331
8/27/2015,Cìkè Niè Yinniáng,15000000,632542,11279884,-3720116,-0.248008
12/1/1995,Things to Do in Denver when You're Dead,15000000,529766,529766,-14470234,-0.964682
4/26/2013,The Reluctant Fundamentalist,15000000,528731,528731,-14471269,-0.964751
2/6/2004,The Return,15000000,501752,5953886,-9046114,-0.603074
7/18/2003,Buffalo Soldiers,15000000,353743,1768976,-13231024,-0.882068
4/25/2003,Steal,15000000,220944,240025,-14759975,-0.983998
8/27/2010,Centurion,15000000,123570,7885048,-7114952,-0.47433
10/23/2009,Ong-Bak 2,15000000,102458,7583050,-7416950,-0.494463
10/12/1996,Silent Trigger,15000000,76382,76382,-14923618,-0.994908
8/1/2008,Midnight Meat Train,15000000,73548,1590246,-13409754,-0.893984
9/6/2013,Winnie Mandela,15000000,61847,61847,-14938153,-0.995877
11/4/2011,The Son of No One,15000000,30680,1148578,-13851422,-0.923428
10/25/2002,All the Queen's Men,15000000,22723,22723,-14977277,-0.998485
10/5/2007,The Good Night,15000000,22441,22441,-14977559,-0.998504
10/11/2013,Khumba,15000000,0,20898221,5898221,0.393215
5/4/2012,A Few Best Men,15000000,0,17224539,2224539,0.148303
10/10/2014,Autómata,15000000,0,6775458,-8224542,-0.548303
12/3/2015,Chiamatemi Francesco - Il papa della gente,15000000,0,3925769,-11074231,-0.738282
,Bathory,15000000,0,3436763,-11563237,-0.770882
2/5/2010,San suk si gin,15000000,0,2013340,-12986660,-0.865777
12/12/2018,Roma,15000000,0,1109544,-13890456,-0.92603
10/6/2005,Dungeons & Dragons 2: The Elemental Might,15000000,0,909822,-14090178,-0.939345
2/17/2017,In Dubious Battle,15000000,0,214182,-14785818,-0.985721
7/23/2021,Midnight in the Switchgrass,15000000,0,97518,-14902482,-0.993499
4/10/2015,Broken Horses,15000000,0,3471,-14996529,-0.999769
6/29/2001,Pandaemonium,15000000,0,1438,-14998562,-0.999904
2/12/1993,Groundhog Day,14600000,71097843,71112677,56512677,3.87073
7/1/2015,Magic Mike XXL,14500000,66013057,123580421,109080421,7.52279
11/1/1996,Romeo+Juliet,14500000,46338728,147542381,133042381,9.17534
7/22/2011,Elle s'appelait Sarah,14500000,7691700,25480031,10980031,0.757244
8/22/2014,Freedom,14500000,0,872757,-13627243,-0.93981
8/7/1992,Unforgiven,14400000,101157447,159157447,144757447,10.0526
1/27/2006,Manderlay,14200000,74205,543306,-13656694,-0.961739
3/23/1990,Pretty Woman,14000000,178406268,432566361,418566361,29.8976
9/18/1987,Fatal Attraction,14000000,156645693,320100000,306100000,21.8643
11/12/2008,Slumdog Millionaire,14000000,141330703,383825427,369825427,26.4161
12/17/1974,Towering Inferno,14000000,116000000,139700000,125700000,8.97857
5/25/1988,Crocodile Dundee 2,14000000,109306210,239606210,225606210,16.1147
12/20/1989,Born on the Fourth of July,14000000,70001698,70001698,56001698,4.00012
10/1/1993,Cool Runnings,14000000,68856263,155008909,141008909,10.0721
1/12/2007,Stomp the Yard,14000000,61356221,75525718,61525718,4.39469
1/16/2009,My Bloody Valentine,14000000,51545952,102836002,88836002,6.34543
8/31/2012,The Possession,14000000,49130588,82925064,68925064,4.92322
10/22/1982,First Blood,14000000,47212904,125212904,111212904,7.94378
7/13/1977,The Spy Who Loved Me,14000000,46800000,185400000,171400000,12.2429
4/12/2019,Breakthrough,14000000,40713082,49231674,35231674,2.51655
9/25/1998,Urban Legend,14000000,38116707,72571864,58571864,4.1837
12/9/1981,Taps,14000000,35856053,35856053,21856053,1.56115
2/24/2012,Tyler Perry's Good Deeds,14000000,35025791,35579177,21579177,1.54137
1/18/1991,White Fang,14000000,34729091,34729091,20729091,1.48065
12/21/1988,Dangerous Liaisons,14000000,34700000,34700000,20700000,1.47857
10/18/2019,Jojo Rabbit,14000000,33370906,87068472,73068472,5.21918
10/8/1999,Superstar,14000000,30628981,30628981,16628981,1.18778
1/13/2012,The Iron Lady,14000000,29959436,115592104,101592104,7.25658
7/23/1993,Poetic Justice,14000000,27450453,27450453,13450453,0.960747
10/4/2002,Jonah: A VeggieTales Movie,14000000,25571351,25608779,11608779,0.829198
3/8/2002,All About the Benjamins,14000000,25482931,25873145,11873145,0.848082
6/17/1977,Exorcist II: The Heretic,14000000,25011000,25011000,11011000,0.7865
3/12/2010,Our Family Wedding,14000000,20255281,21410546,7410546,0.529325
10/27/1995,Vampire in Brooklyn,14000000,19637147,19637147,5637147,0.402653
5/5/2006,An American Haunting,14000000,16298046,30443277,16443277,1.17452
8/22/2003,My Boss's Daughter,14000000,15549702,15565357,1565357,0.111811
8/7/2009,A Perfect Getaway,14000000,15515460,22815460,8815460,0.629676
10/25/1996,Thinner,14000000,15171475,15171475,1171475,0.0836768
8/21/1998,Dead Man on Campus,14000000,15064948,15064948,1064948,0.0760677
5/14/1999,Tea with Mussolini,14000000,14395874,14395874,395874,0.0282767
6/22/1977,New York New York,14000000,13800000,13800000,-200000,-0.0142857
4/26/2002,Jason X,14000000,13121555,16951798,2951798,0.210843
5/13/1994,Crooklyn,14000000,13024170,13024170,-975830,-0.0697021
3/16/2007,I Think I Love My Wife,14000000,12559771,13205411,-794589,-0.0567564
2/20/2015,Hot Tub Time Machine 2,14000000,12314651,12826644,-1173356,-0.0838111
4/12/2019,After,14000000,12138565,58090525,44090525,3.14932
11/17/2006,Bobby,14000000,11242801,20597806,6597806,0.471272
2/2/2001,Head Over Heels,14000000,10397365,10397365,-3602635,-0.257331
10/26/2012,Fun Size,14000000,9409538,11166615,-2833385,-0.202385
4/23/1999,Lost and Found,14000000,6552255,6552255,-7447745,-0.531982
11/30/2007,Le Scaphandre et le Papillon,14000000,5990075,22754472,8754472,0.625319
10/6/2006,Little Children,14000000,5463019,14121177,121177,0.0086555
4/21/2000,Gossip,14000000,5108820,12591270,-1408730,-0.100624
3/26/1999,A Walk on the Moon,14000000,4741987,4741987,-9258013,-0.661287
12/26/2014,Suffragette,14000000,4702420,37888043,23888043,1.70629
10/27/2006,Catch a Fire,14000000,4299773,5782198,-8217802,-0.586986
10/31/2014,Mr. Turner,14000000,3958546,25187026,11187026,0.799073
9/7/2001,Soul Survivors,14000000,3100650,4288246,-9711754,-0.693697
5/22/2009,Easy Virtue,14000000,2656784,20537741,6537741,0.466981
3/31/1995,Jefferson in Paris,14000000,2461628,2461628,-11538372,-0.824169
8/6/2010,Flipped,14000000,1755212,4294635,-9705365,-0.69324
1/1/1978,Caravans,14000000,1000000,1000000,-13000000,-0.928571
6/25/2010,Les herbes folles,14000000,403952,1903952,-12096048,-0.864003
1/24/2003,Amen,14000000,274299,274299,-13725701,-0.980407
9/26/2008,The Lucky Ones,14000000,266967,266967,-13733033,-0.980931
9/30/2011,Margaret,14000000,47185,623292,-13376708,-0.955479
7/25/2014,The Salvation,14000000,43318,2947737,-11052263,-0.789447
8/3/2012,Reign of Assassins,14000000,0,11354230,-2645770,-0.188984
12/9/2005,Brokeback Mountain,13900000,83043761,176980863,163080863,11.7324
7/1/1995,Clueless,13700000,56598476,57956568,44256568,3.23041
,Cah,13700000,0,11738256,-1961744,-0.143193
3/30/1990,Teenage Mutant Ninja Turtles,13500000,135265915,202000000,188500000,13.963
10/5/2056,The Ten Commandments,13500000,85400591,85433929,71933929,5.32844
12/16/1973,Papillon,13500000,53267000,53292989,39792989,2.94763
4/20/2018,Super Troopers 2,13500000,30617396,31575635,18075635,1.33894
11/8/2002,Far From Heaven,13500000,15901849,29027914,15527914,1.15022
10/12/2012,Seven Psychopaths,13500000,15024049,33035736,19535736,1.44709
11/22/2000,Quills,13500000,7060876,11732088,-1767912,-0.130956
1/29/1982,The Border,13500000,6118683,6118683,-7381317,-0.546764
2/18/2005,Der Untergang,13500000,5501940,93631744,80131744,5.93568
3/2/2001,The Caveman's Valentine,13500000,687081,892506,-12607494,-0.933888
4/1/2011,The Last Godfather,13400000,164247,164247,-13235753,-0.987743
3/14/2014,Under the Skin,13300000,2614251,7229933,-6070067,-0.456396
12/17/2004,Mar adentro,13300000,2086345,39686345,26386345,1.98394
9/12/2014,No Good Deed,13200000,52543632,54323210,41123210,3.11539
12/19/2019,Pinocchio,13200000,1831718,25995655,12795655,0.969368
12/23/1987,Good Morning Vietnam,13000000,123922370,123922370,110922370,8.53249
12/3/2010,Black Swan,13000000,106954678,331266710,318266710,24.4821
1/12/2001,Save the Last Dance,13000000,91038276,122244329,109244329,8.40341
2/11/2011,Justin Bieber: Never Say Never,13000000,73013910,99034125,86034125,6.61801
7/4/2018,The First Purge,13000000,69488745,137054597,124054597,9.54266
3/16/2016,Miracles from Heaven,13000000,61705123,73814432,60814432,4.67803
2/11/2000,Snow Day,13000000,60008303,62452927,49452927,3.80407
1/23/2004,The Butterfly Effect,13000000,57924679,95638592,82638592,6.35681
12/11/1974,The Godfather: Part II,13000000,57300000,57300000,44300000,3.40769
6/23/2016,The Shallows,13000000,55121623,118763442,105763442,8.13565
7/17/1987,RoboCop,13000000,53424681,53425390,40425390,3.10965
8/19/1988,A Nightmare on Elm Street 4: The Dream Master,13000000,49369899,49369899,36369899,2.79768
11/21/2007,This Christmas,13000000,49121934,49733545,36733545,2.82566
2/14/2014,About Last Night,13000000,48637684,50445860,37445860,2.88045
12/15/2000,Dude Where's My Car?,13000000,46729374,73180297,60180297,4.62925
8/12/1988,Young Guns,13000000,44726644,44726644,31726644,2.44051
10/10/2014,St. Vincent,13000000,44137712,54837234,41837234,3.21825
7/2/2014,Earth to Echo,13000000,38934842,42174545,29174545,2.2442
3/31/1999,10 Things I Hate About You,13000000,38177966,60413950,47413950,3.64723
5/10/2002,The New Guy,13000000,28972187,28972187,15972187,1.22863
2/5/1993,Loaded Weapon 1,13000000,27979399,27979399,14979399,1.15226
3/12/1999,Baby Geniuses,13000000,27151490,27151490,14151490,1.08858
4/24/1998,The Big Hit,13000000,27066941,27066941,14066941,1.08207
11/9/1990,Child's Play 2,13000000,26904572,34166572,21166572,1.6282
7/10/1996,Harriet the Spy,13000000,26570048,26570048,13570048,1.04385
3/1/2013,21 and Over,13000000,25682380,42195766,29195766,2.24583
11/21/2007,The Mist,13000000,25593755,57189408,44189408,3.39919
1/21/2015,Ex Machina,13000000,25440971,38358392,25358392,1.95065
10/29/1999,Being John Malkovich,13000000,22858926,32382381,19382381,1.49095
9/7/2001,Two Can Play That Game,13000000,22235901,22391450,9391450,0.722419
3/11/2016,Eye in the Sky,13000000,18704596,35402802,22402802,1.72329
3/22/2013,Admission,13000000,18007317,18733666,5733666,0.441051
9/20/2012,The Perks of Being a Wallflower,13000000,17742948,33069303,20069303,1.54379
6/29/2001,crazy/beautiful,13000000,16929123,19929123,6929123,0.533009
8/28/1998,54,13000000,16757163,16757163,3757163,0.289013
10/16/2015,Room,13000000,14677674,36311350,23311350,1.79318
10/16/2015,Woodlawn,13000000,14394097,14403891,1403891,0.107992
12/20/2006,Letters from Iwo Jima,13000000,13756082,67867998,54867998,4.22062
5/29/2009,Män som hatar kvinnor,13000000,12749992,109421911,96421911,7.41707
2/23/2007,The Astronaut Farmer,13000000,11003643,11141213,-1858787,-0.142984
6/12/1998,Dirty Work,13000000,10020081,10020081,-2979919,-0.229225
7/16/2015,Bajrangi Bhaijaan,13000000,8178001,121778347,108778347,8.36757
5/8/1998,Woo,13000000,8064972,8064972,-4935028,-0.379618
2/4/2016,Robinson Crusoe,13000000,8005586,42446455,29446455,2.26511
4/13/1994,Serial Mom,13000000,7881335,7881335,-5118665,-0.393743
8/4/1999,Dick,13000000,6276869,6276869,-6723131,-0.517164
11/10/1999,Light It Up,13000000,5871603,5871603,-7128397,-0.548338
8/24/2001,Bubble Boy,13000000,5002310,5002310,-7997690,-0.615207
2/1/2002,Birthday Girl,13000000,4919896,8130727,-4869273,-0.374559
2/1/2007,Paris je t'aime,13000000,4857374,5175088,-7824912,-0.601916
12/7/2018,Ben is Back,13000000,3703182,12616995,-383005,-0.0294619
8/24/2007,Resurrecting the Champ,13000000,3172382,3260555,-9739445,-0.749188
3/26/2010,Chloe,13000000,3075255,13176612,176612,0.0135855
3/2/2001,The Widow of St. Pierre,13000000,3058380,3058380,-9941620,-0.76474
5/22/2015,Youth,13000000,2703296,24001573,11001573,0.846275
4/5/1996,Faithful,13000000,2104439,2104439,-10895561,-0.83812
2/26/2010,Un Prophète,13000000,2087720,19910624,6910624,0.531586
12/3/2010,I Love You Phillip Morris,13000000,2037459,23014027,10014027,0.77031
7/23/2015,The Vatican Tapes,13000000,1784763,14929184,1929184,0.148399
3/17/2006,Find Me Guilty,13000000,1173673,2898225,-10101775,-0.77706
5/14/1993,Excessive Force,13000000,1152117,1152117,-11847883,-0.911376
10/13/2006,Infamous,13000000,1151330,2613717,-10386283,-0.798945
7/29/2011,Attack the Block,13000000,1024175,6459183,-6540817,-0.50314
8/13/2015,Brothers,13000000,656688,17856688,4856688,0.373591
12/29/2000,The Claim,13000000,622023,1375635,-11624365,-0.894182
4/12/2018,The Happy Prince,13000000,464495,2394619,-10605381,-0.815799
12/23/2011,In The Land of Blood and Honey,13000000,303877,509193,-12490807,-0.960831
6/18/2010,The Killer Inside Me,13000000,217277,5453369,-7546631,-0.58051
12/7/2018,Dumplin’,13000000,0,399198,-12600802,-0.969292
10/30/2020,Rogue City,13000000,0,8573,-12991427,-0.999341
3/30/2012,Womb,13000000,0,0,-13000000,-1
3/14/2013,The Call,12800000,51872378,69821476,57021476,4.4548
7/20/2016,Operation Chromite,12700000,1022720,49196532,36496532,2.87374
9/12/2014,The Drop,12600000,10724389,19054534,6454534,0.512265
7/12/2002,The Crocodile Hunter: Collision Course,12500000,28436931,33436931,20936931,1.67495
9/3/2010,Machete,12500000,26593646,46370970,33870970,2.70968
12/19/2002,Antwone Fisher,12500000,21078145,23367586,10867586,0.869407
2/12/1982,La Guerre du feu,12500000,20959585,20959585,8459585,0.676767
11/22/2002,The Emperor's Club,12500000,14060950,16193713,3693713,0.295497
9/10/1993,True Romance,12500000,12281000,12643293,143293,0.0114634
9/11/2009,Sorority Row,12500000,11965282,26735797,14235797,1.13886
9/30/1992,Glengarry Glen Ross,12500000,10725228,10725650,-1774350,-0.141948
11/7/2008,The Boy in the Striped Pyjamas,12500000,9046156,44083403,31583403,2.52667
4/2/1982,Cat People,12500000,7000000,21000000,8500000,0.68
5/25/1979,The Prisoner of Zenda,12500000,7000000,7000000,-5500000,-0.44
10/15/2010,Conviction,12500000,6797696,11826980,-673020,-0.0538416
10/12/2007,Lars and the Real Girl,12500000,5956480,11277119,-1222881,-0.0978305
5/21/2010,Solitary Man,12500000,4360548,4360548,-8139452,-0.651156
9/22/2000,Dancer in the Dark,12500000,4157491,45556774,33056774,2.64454
12/17/2010,Casino Jack,12500000,2039869,2272186,-10227814,-0.818225
1/2/1998,Oscar and Lucinda,12500000,1612957,1612957,-10887043,-0.870963
11/1/1996,The Funeral,12500000,1212799,1412799,-11087201,-0.886976
9/3/2004,Tae Guik Gi: The Brotherhood of War,12500000,1110186,69826708,57326708,4.58614
4/16/2010,The Perfect Game,12500000,1089445,3931367,-8568633,-0.685491
10/5/2012,The Paperboy,12500000,677200,4027663,-8472337,-0.677787
12/12/2012,Ernest et Celestine,12500000,292562,9376444,-3123556,-0.249884
2/9/2012,A Little Bit of Heaven,12500000,10011,1100287,-11399713,-0.911977
11/1/2016,La Folle Histoire De Max Et Léon,12500000,0,8912003,-3587997,-0.28704
11/28/2014,Mortadelo y Filemón contra Jimmy el Cachondo,12500000,0,3350943,-9149057,-0.731925
11/18/1988,The Land Before Time,12300000,48092846,81972846,69672846,5.66446
6/20/1975,Jaws,12000000,260000000,470700000,458700000,38.225
12/26/1973,The Exorcist,12000000,230347346,428214478,416214478,34.6845
6/4/2014,The Fault in Our Stars,12000000,124872350,307166834,295166834,24.5972
7/9/1999,American Pie,12000000,101800948,234723148,222723148,18.5603
4/20/2012,Think Like a Man,12000000,91547205,113373764,101373764,8.44781
4/16/2014,Heaven is for Real,12000000,91386097,100913556,88913556,7.40946
12/12/1986,The Golden Child,12000000,79817937,79817937,67817937,5.65149
6/4/1982,Star Trek II: The Wrath of Khan,12000000,78912963,95800000,83800000,6.98333
9/13/2002,Barbershop,12000000,75781642,77063461,65063461,5.42196
6/3/1983,WarGames,12000000,74433837,74433837,62433837,5.20282
2/4/1994,Ace Ventura: Pet Detective,12000000,72217396,107217396,95217396,7.93478
2/24/2012,Act of Valor,12000000,70012847,82497035,70497035,5.87475
2/8/1985,Witness,12000000,65532576,65532576,53532576,4.46105
8/11/2006,Step Up,12000000,65328121,110989157,98989157,8.2491
2/2/2012,Chronicle,12000000,64575175,123681790,111681790,9.30682
12/20/1996,Beavis and Butt-Head Do America,12000000,63118386,63118386,51118386,4.25987
1/1/2070,Patton,12000000,62500000,62500000,50500000,4.20833
3/2/2012,Project X,12000000,54731865,103028188,91028188,7.58568
11/10/2017,Three Billboards Outside Ebbing Missouri,12000000,54513740,161456746,149456746,12.4547
11/25/2016,Lion,12000000,51739495,149117900,137117900,11.4265
5/4/2018,Overboard,12000000,50316123,91244913,79244913,6.60374
12/25/1997,Jackie Brown,12000000,39673162,74727492,62727492,5.22729
11/18/1983,Yentl,12000000,39012241,39012241,27012241,2.25102
4/25/2008,Harold & Kumar Escape from Guantanamo Bay,12000000,38108728,43353117,31353117,2.61276
11/1/2013,Philomena,12000000,37709979,98963392,86963392,7.24695
11/6/1981,Time Bandits,12000000,37400000,37400000,25400000,2.11667
2/15/2002,Crossroads,12000000,37188667,57000000,45000000,3.75
7/9/2015,Paper Towns,12000000,32000304,85450484,73450484,6.12087
10/10/2008,Quarantine,12000000,31691811,41924774,29924774,2.49373
8/21/2002,One Hour Photo,12000000,31597131,52223306,40223306,3.35194
2/1/2008,The Eye,12000000,31418697,57577765,45577765,3.79815
4/7/2004,Johnson Family Vacation,12000000,31203964,31286759,19286759,1.60723
12/21/2001,How High,12000000,31155435,31222395,19222395,1.60187
10/7/2060,Spartacus,12000000,30000000,60000000,48000000,4
9/1/2006,Crank,12000000,27838408,43924923,31924923,2.66041
12/11/1992,The Muppet Christmas Carol,12000000,27379507,27972958,15972958,1.33108
8/12/2016,Hell or High Water,12000000,27007844,37584304,25584304,2.13203
10/25/2002,Frida,12000000,25885000,56131239,44131239,3.6776
7/5/2012,Katy Perry: Part of Me,12000000,25326071,32700439,20700439,1.72504
12/12/2014,Top Five,12000000,25317379,26001741,14001741,1.16681
9/11/1998,Rounders,12000000,22921898,22921898,10921898,0.910158
10/13/1993,Rudy,12000000,22750363,22750363,10750363,0.895864
4/28/2067,Casino Royale,12000000,22744718,41744718,29744718,2.47873
6/15/1979,Prophecy,12000000,22673340,22673340,10673340,0.889445
1/30/2015,Project Almanac,12000000,22348241,32909437,20909437,1.74245
8/15/2019,47 Meters Down: Uncaged,12000000,22260900,37989240,25989240,2.16577
10/23/2019,Black and Blue,12000000,22012729,22730144,10730144,0.894179
5/14/2010,Just Wright,12000000,21540363,21867665,9867665,0.822305
9/10/1999,Stir of Echoes,12000000,21133087,23059379,11059379,0.921615
1/13/1995,Tales from the Crypt: Demon Knight,12000000,21089146,21089146,9089146,0.757429
1/1/1978,The Boys from Brazil,12000000,19000000,19000000,7000000,0.583333
3/11/2005,The Upside of Anger,12000000,18761993,28915761,16915761,1.40965
3/3/2006,Aquamarine,12000000,18597342,22978953,10978953,0.914913
11/15/2013,Nebraska,12000000,17654912,24761360,12761360,1.06345
1/9/2004,My Baby's Daddy,12000000,17321573,17322212,5322212,0.443518
10/5/2001,Max Keeble's Big Move,12000000,17292381,17292381,5292381,0.441032
12/9/2011,Young Adult,12000000,16311571,22750356,10750356,0.895863
1/23/2020,The Turning,12000000,15472775,18460739,6460739,0.538395
9/4/2013,About Time,12000000,15323921,88538742,76538742,6.37823
12/14/2018,If Beale Street Could Talk,12000000,14915773,21398371,9398371,0.783198
7/14/2017,Wish Upon,12000000,14301505,23477345,11477345,0.956445
8/6/1997,Def Jam's How To Be a Player,12000000,14010363,14010363,2010363,0.16753
10/30/1998,Living Out Loud,12000000,12905901,12905901,905901,0.0754917
10/3/2008,Rachel Getting Married,12000000,12796861,17475475,5475475,0.45629
3/20/1981,The Postman Always Rings Twice,12000000,12200000,44200000,32200000,2.68333
12/12/2003,Girl with a Pearl Earring,12000000,11634362,43153588,31153588,2.59613
2/10/1982,Das Boot,12000000,11487676,84970337,72970337,6.08086
2/26/2016,Unforgettable,12000000,11368012,16221211,4221211,0.351768
12/3/2004,House of Flying Daggers,12000000,11050094,92863945,80863945,6.73866
3/11/2020,I Still Believe,12000000,10410004,16368001,4368001,0.364
3/22/2002,Sorority Boys,12000000,10198766,12516222,516222,0.0430185
10/13/2017,Marshall,12000000,10051659,10116816,-1883184,-0.156932
12/5/2008,Cadillac Records,12000000,8195551,8942516,-3057484,-0.25479
9/14/2012,Arbitrage,12000000,7919574,35830713,23830713,1.98589
10/24/2060,The Alamo,12000000,7900000,7900000,-4100000,-0.341667
5/12/2000,Screwed,12000000,6982680,6982680,-5017320,-0.41811
10/20/2006,Running With Scissors,12000000,6860000,8706701,-3293299,-0.274442
9/3/1993,Fortress,12000000,6730578,46730578,34730578,2.89421
4/20/2012,For Greater Glory: The True Story of Cristiada,12000000,5669081,10026255,-1973745,-0.164479
11/17/2006,For Your Consideration,12000000,5549923,5549923,-6450077,-0.537506
11/20/1998,Celebrity,12000000,5078660,6200000,-5800000,-0.483333
6/20/2003,From Justin to Kelly,12000000,4922166,4922166,-7077834,-0.58982
6/6/1986,Invaders from Mars,12000000,4884663,4984663,-7015337,-0.584611
3/22/1996,Girl 6,12000000,4880941,4880941,-7119059,-0.593255
10/22/2003,In the Cut,12000000,4717455,23693646,11693646,0.974471
2/22/2008,Charlie Bartlett,12000000,3950294,5295909,-6704091,-0.558674
2/13/2009,Two Lovers,12000000,3149034,16349034,4349034,0.36242
11/15/2013,La grande bellezza,12000000,2883879,29545082,17545082,1.46209
2/15/2002,Last Orders,12000000,2326407,2326407,-9673593,-0.806133
3/9/2007,Gwoemul,12000000,2201923,92618117,80618117,6.71818
11/13/1981,The Pursuit of D.B. Cooper,12000000,2104164,2104164,-9895836,-0.824653
3/19/1999,Ravenous,12000000,2062406,2062406,-9937594,-0.828133
6/14/2002,The Dangerous Lives of Altar Boys,12000000,1779284,1779284,-10220716,-0.851726
2/28/2013,Stoker,12000000,1703125,12034913,34913,0.00290942
3/7/2008,Married Life,12000000,1506998,2975188,-9024812,-0.752068
10/15/2004,2046,12000000,1442338,19278598,7278598,0.60655
3/11/2011,Kill the Irishman,12000000,1188194,1188194,-10811806,-0.900984
9/30/2005,Duma,12000000,870067,994790,-11005210,-0.917101
4/20/2012,Darling Companion,12000000,793352,1200346,-10799654,-0.899971
6/4/2010,Ondine,12000000,550472,557545,-11442455,-0.953538
7/20/2001,Brother,12000000,450594,477693,-11522307,-0.960192
10/4/2002,Welcome to Collinwood,12000000,378650,4606284,-7393716,-0.616143
8/7/2015,Kahlil Gibran's The Prophet,12000000,340536,1080362,-10919638,-0.90997
4/18/2008,Life Before Her Eyes,12000000,303439,7203439,-4796561,-0.399713
10/31/1997,Critical Care,12000000,220175,220175,-11779825,-0.981652
9/28/2007,Trade,12000000,214202,1513388,-10486612,-0.873884
1/6/2006,Fateless,12000000,196857,196857,-11803143,-0.983595
9/3/2010,San qiang pai an jing qi,12000000,190946,310946,-11689054,-0.974088
9/17/1999,Breakfast of Champions,12000000,178287,178287,-11821713,-0.985143
3/9/2001,Company Man,12000000,146028,622273,-11377727,-0.948144
11/7/2009,Nanjing! Nanjing!,12000000,122558,20122558,8122558,0.67688
6/29/2018,Woman Walks Ahead,12000000,57528,627538,-11372462,-0.947705
2/21/2015,Trash,12000000,17484,6553186,-5446814,-0.453901
8/19/2011,5 Days of War,12000000,17479,87793,-11912207,-0.992684
11/11/2015,10 Days in a Madhouse,12000000,14616,14616,-11985384,-0.998782
4/7/2009,1612,12000000,0,5400624,-6599376,-0.549948
9/4/2015,San cheng ji,12000000,0,1950194,-10049806,-0.837484
4/19/2012,Tu Xia Chuan Qi,12000000,0,1828400,-10171600,-0.847633
2/10/2010,Triangle,12000000,0,1594955,-10405045,-0.867087
10/19/2013,Supesu Batorushippu Yamato,12000000,0,0,-12000000,-1
10/3/2014,Drive Hard,12000000,0,0,-12000000,-1
10/30/2015,Dancin' It's On,12000000,0,0,-12000000,-1
6/5/2009,Home,12000000,0,0,-12000000,-1
10/30/2015,The Dressmaker,11900000,2022115,24374909,12474909,1.04831
12/10/1999,Diamonds,11900000,81897,81897,-11818103,-0.993118
6/7/1997,Madadayo,11900000,48856,49451,-11850549,-0.995844
5/30/2019,Gisaengchung,11800000,53369745,254688898,242888898,20.5838
11/20/2015,Carol,11800000,12711491,42666442,30866442,2.6158
4/21/1989,Pet Sematary,11500000,57469179,57469850,45969850,3.99738
1/21/2016,Dirty Grandpa,11500000,35593113,105078449,93578449,8.13726
11/27/2009,The Cry of the Owl,11500000,0,0,-11500000,-1
10/9/2009,St. Trinian’s,11400000,15000,29830239,18430239,1.61669
5/25/1977,Star Wars Ep. IV: A New Hope,11000000,460998007,775398007,764398007,69.4907
6/8/1984,Gremlins,11000000,148168459,148951992,137951992,12.5411
12/22/2065,Doctor Zhivago,11000000,111897830,112040388,101040388,9.18549
12/10/2010,The Fighter,11000000,93617009,129262388,118262388,10.7511
10/24/2008,High School Musical 3: Senior Year,11000000,90559416,274392880,263392880,23.9448
12/27/1991,Fried Green Tomatoes,11000000,81204830,81204830,70204830,6.38226
9/22/2006,Jackass: Number Two,11000000,72778712,85278712,74278712,6.75261
3/13/1992,My Cousin Vinny,11000000,52929168,52929168,41929168,3.81174
8/22/2014,If I Stay,11000000,50474843,78356170,67356170,6.12329
4/7/1989,Major League,11000000,49793054,49793054,38793054,3.52664
4/4/2003,Phone Booth,11000000,46566212,97837138,86837138,7.89429
1/25/2002,A Walk to Remember,11000000,41227069,46060861,35060861,3.18735
12/29/1995,Dead Man Walking,11000000,39387284,83088295,72088295,6.55348
3/5/1999,Cruel Intentions,11000000,38665260,76238901,65238901,5.93081
11/4/2015,Brooklyn,11000000,38322743,62076141,51076141,4.64329
10/17/2008,The Secret Life of Bees,11000000,37780486,39994347,28994347,2.63585
6/16/2017,Wind River,11000000,33800859,44998252,33998252,3.09075
4/1/2015,Woman in Gold,11000000,33307793,58586407,47586407,4.32604
6/12/1981,History of the World: Part I,11000000,31672000,31672000,20672000,1.87927
12/8/2017,I Tonya,11000000,30014534,53797409,42797409,3.89067
10/23/2009,Saw VI,11000000,27693292,69752402,58752402,5.34113
10/12/2001,Corky Romano,11000000,23978402,25116103,14116103,1.28328
2/14/2019,Fighting With My Family,11000000,22958583,41503089,30503089,2.77301
8/7/1992,Raising Cain,11000000,21171695,21171695,10171695,0.9247
4/13/1978,F.I.S.T,11000000,20388920,20388920,9388920,0.853538
1/1/1975,Barry Lyndon,11000000,20000000,20169934,9169934,0.83363
12/26/2012,Quartet,11000000,18388357,56178935,45178935,4.10718
11/21/2001,Out Cold,11000000,13906394,14786394,3786394,0.344218
10/13/2000,The Ladies Man,11000000,13592872,13719474,2719474,0.247225
3/30/2001,Tomcats,11000000,13558739,13558739,2558739,0.232613
11/6/2013,Inside Llewyn Davis,11000000,13248209,32943247,21943247,1.99484
4/12/2002,Frailty,11000000,13110448,19947280,8947280,0.813389
2/19/1993,Army of Darkness,11000000,11502976,21502976,10502976,0.954816
11/12/2004,Kinsey,11000000,10214647,17443529,6443529,0.585775
5/10/2013,Peeples,11000000,9177065,9307166,-1692834,-0.153894
12/25/1993,What's Eating Gilbert Grape,11000000,9170214,9170214,-1829786,-0.166344
11/2/2018,Boy Erased,11000000,6788692,11862650,862650,0.0784227
7/1/2016,Sultan,11000000,5599781,72989781,61989781,5.63543
2/1/2002,Slackers,11000000,4814244,5942218,-5057782,-0.459798
9/26/2003,The Gospel of John,11000000,4068087,4234355,-6765645,-0.615059
10/10/2004,Vera Drake,11000000,3753806,13353855,2353855,0.213987
10/14/2011,La piel que habito,11000000,3185193,38190517,27190517,2.47187
1/31/2003,The Guru,11000000,3051221,24150550,13150550,1.1955
12/14/1995,Othello,11000000,2844379,2844379,-8155621,-0.74142
5/12/1995,The Perez Family,11000000,2794056,2794056,-8205944,-0.745995
1/1/1970,The Molly Maguires,11000000,2200000,2200000,-8800000,-0.8
1/1/1991,Return to the Blue Lagoon,11000000,2000000,2000000,-9000000,-0.818182
7/1/2016,La Tortue Rouge,11000000,920057,6712903,-4287097,-0.389736
9/7/2007,Romance and Cigarettes,11000000,551002,3231251,-7768749,-0.70625
11/10/2006,Copying Beethoven,11000000,355968,6586324,-4413676,-0.401243
8/26/2011,Brighton Rock,11000000,229653,229653,-10770347,-0.979122
11/16/2012,Le prénom,11000000,61611,25307405,14307405,1.30067
5/4/2012,LOL,11000000,46000,10477506,-522494,-0.0474995
12/17/2014,La famille Bélier,11000000,0,82438670,71438670,6.49442
3/6/2020,The Banker,11000000,0,2670000,-8330000,-0.757273
2/5/2016,Misconduct,11000000,0,2352511,-8647489,-0.786135
10/18/2019,Eli,11000000,0,0,-11000000,-1
10/24/2008,Saw V,10800000,56746769,118209778,107409778,9.94535
3/30/2012,Les Intouchables,10800000,13182281,484630908,473830908,43.8732
4/27/2007,Jindabyne,10800000,399879,2862544,-7937456,-0.73495
8/11/2006,Kabhi Alvida Naa Kehna,10750000,3275443,32575443,21825443,2.03027
6/4/1982,Poltergeist,10700000,74706019,121706019,111006019,10.3744
5/25/1979,Alien,10700000,62005728,184694992,173994992,16.2612
6/18/1999,An Ideal Husband,10700000,18542974,31341183,20641183,1.92908
12/25/2004,Darkness,10600000,22163442,34409206,23809206,2.24615
12/6/2013,The Last Days on Mars,10600000,24084,261364,-10338636,-0.975343
6/11/1982,E.T. the Extra-Terrestrial,10500000,435110554,792962972,782462972,74.5203
4/2/2068,2001: A Space Odyssey,10500000,59936321,71854587,61354587,5.84329
4/20/2007,In the Land of Women,10500000,11052958,14140402,3640402,0.346705
9/2/1994,There Goes My Baby,10500000,125169,125169,-10374831,-0.988079
2/20/2004,The Blue Butterfly,10400000,1610194,1610194,-8789806,-0.845174
9/1/2001,Le Fabuleux destin d'Amélie Poulain,10350000,33201661,174195760,163845760,15.8305
12/26/2018,PMC: deo beong-keo,10300000,0,12478635,2178635,0.211518
2/18/1983,Lovesick,10100000,10143618,10143618,43618,0.00431861
4/30/2010,Housefull,10100000,1183658,18726300,8626300,0.854089
8/24/2007,September Dawn,10100000,1066555,1066555,-9033445,-0.8944
10/17/2018,Halloween,10000000,159366015,255416089,245416089,24.5416
12/5/1997,Good Will Hunting,10000000,138433435,225925989,215925989,21.5926
10/22/2004,The Grudge,10000000,110359362,187281115,177281115,17.7281
8/25/2016,Don’t Breathe,10000000,89217875,158906350,148906350,14.8906
6/26/1981,Stripes,10000000,85300000,85300000,75300000,7.53
10/27/2006,Saw III,10000000,80238724,163876815,153876815,15.3877
7/1/2016,The Purge: Election Year,10000000,79042440,118514727,108514727,10.8515
5/18/2018,Book Club,10000000,68566296,91328463,81328463,8.13285
8/25/2000,Bring it On,10000000,68353550,90453550,80453550,8.04536
1/3/2018,Insidious: The Last Key,10000000,67745330,172811971,162811971,16.2812
1/29/1999,She's All That,10000000,63465522,63465522,53465522,5.34655
10/26/2007,Saw IV,10000000,63300095,135759694,125759694,12.576
2/24/2006,Madea's Family Reunion,10000000,63257940,63320521,53320521,5.33205
1/7/2005,White Noise,10000000,56094360,92094360,82094360,8.20944
10/17/1986,The Color of Money,10000000,52293000,52293000,42293000,4.2293
6/4/2015,Insidious Chapter 3,10000000,52218558,120453155,110453155,11.0453
10/2/1992,The Mighty Ducks,10000000,50752337,50752337,40752337,4.07523
11/3/2017,Lady Bird,10000000,48958273,78944998,68944998,6.8945
11/6/2009,Precious (Based on the Novel Push by Sapphire),10000000,47566524,68722848,58722848,5.87228
2/24/2012,The Best Exotic Marigold Hotel,10000000,46383639,134639780,124639780,12.464
6/1/2018,Hereditary,10000000,44069456,81263489,71263489,7.12635
3/16/2018,Love Simon,10000000,40826341,65520633,55520633,5.55206
2/17/1989,Bill & Ted’s Excellent Adventure,10000000,40485039,40510111,30510111,3.05101
10/4/2062,The Longest Day,10000000,39100000,50100000,40100000,4.01
2/16/1996,Happy Gilmore,10000000,38623460,41004412,31004412,3.10044
10/27/2017,Jigsaw,10000000,38052832,104223315,94223315,9.42233
8/31/2001,Jeepers Creepers,10000000,37904175,58939035,48939035,4.8939
6/28/1985,St. Elmo’s Fire,10000000,37800000,37800000,27800000,2.78
12/11/2068,Oliver!,10000000,37402877,37402877,27402877,2.74029
2/16/2001,Recess: School's Out,10000000,36696761,44451470,34451470,3.44515
7/10/1985,Mad Max Beyond Thunderdome,10000000,36230219,36230219,26230219,2.62302
11/3/1977,Pete’s Dragon,10000000,36000000,36000000,26000000,2.6
1/21/2016,The Boy,10000000,35819556,68220952,58220952,5.8221
10/4/1985,Commando,10000000,35073978,35078864,25078864,2.50789
5/19/2017,Everything Everything,10000000,34121140,61603136,51603136,5.16031
9/17/2010,Devil,10000000,33679655,63354114,53354114,5.33541
11/22/2002,Friday After Next,10000000,33253609,33526835,23526835,2.35268
2/26/2015,The Second Best Exotic Marigold Hotel,10000000,33078266,89400862,79400862,7.94009
3/22/1985,The Last Dragon,10000000,33000000,33000447,23000447,2.30004
4/28/2017,How to Be a Latin Lover,10000000,32149404,62556228,52556228,5.25562
3/6/1992,The Lawnmower Man,10000000,32100816,32100816,22100816,2.21008
10/3/2008,Nick and Norah's Infinite Playlist,10000000,31487293,33886017,23886017,2.3886
10/9/2003,Calendar Girls,10000000,31011616,93074616,83074616,8.30746
11/12/1999,Dogma,10000000,30651422,43948865,33948865,3.39489
5/18/2018,Slender Man,10000000,30564825,51945949,41945949,4.19459
9/20/2002,The Banger Sisters,10000000,30306281,38067218,28067218,2.80672
12/8/2000,Snatch,10000000,30093107,83593107,73593107,7.35931
5/19/1989,Road House,10000000,30050028,30050028,20050028,2.005
7/27/2018,Teen Titans Go! To The Movies,10000000,29790236,51620593,41620593,4.16206
9/8/2016,When the Bough Breaks,10000000,29747603,30768449,20768449,2.07684
6/24/1983,Twilight Zone: The Movie,10000000,29500000,29500000,19500000,1.95
11/23/1994,A Low Down Dirty Shame,10000000,29317886,29317886,19317886,1.93179
8/30/2013,One Direction: This is Us,10000000,28873374,68413020,58413020,5.8413
9/6/2002,Swimfan,10000000,28564995,34084228,24084228,2.40842
10/6/2006,Employee of the Month,10000000,28444855,38364855,28364855,2.83649
8/19/2015,Sinister 2,10000000,27740955,54104225,44104225,4.41042
1/7/2016,The Forest,10000000,26594261,40749230,30749230,3.07492
11/6/2009,The Fourth Kind,10000000,26218170,49486874,39486874,3.94869
3/25/1983,The Outsiders,10000000,25697647,25707720,15707720,1.57077
6/12/1998,Can't Hardly Wait,10000000,25358996,25358996,15358996,1.5359
8/17/2012,Sparkle,10000000,24397469,24660323,14660323,1.46603
10/14/2016,Kevin Hart: What Now?,10000000,23591043,23591043,13591043,1.3591
4/26/2013,Mud,10000000,21590086,31556959,21556959,2.1557
11/12/2010,Skyline,10000000,21416355,68264973,58264973,5.8265
12/31/2019,The Grudge,10000000,21216148,49503265,39503265,3.95033
12/1/2017,The Disaster Artist,10000000,21120616,28717667,18717667,1.87177
9/15/2016,Blair Witch,10000000,20777061,38985577,28985577,2.89856
10/21/1983,The Dead Zone,10000000,20766000,20766000,10766000,1.0766
2/7/1986,F/X,10000000,20603715,20603715,10603715,1.06037
2/2/2001,Valentine,10000000,20384136,20384136,10384136,1.03841
6/9/2006,A Prairie Home Companion,10000000,20342852,26716191,16716191,1.67162
2/23/2007,Reno 911!: Miami,10000000,20342161,21851362,11851362,1.18514
7/24/1998,Jane Austen's Mafia,10000000,19843795,30143795,20143795,2.01438
10/21/2015,Paranormal Activity: The Ghost Dimension,10000000,18297124,77959374,67959374,6.79594
2/25/1994,Sugar Hill,10000000,18272447,18423914,8423914,0.842391
6/20/2008,Kit Kittredge: An American Girl,10000000,17657973,17657973,7657973,0.765797
9/27/1985,Invasion U.S.A.,10000000,17536256,17536256,7536256,0.753626
9/23/2005,Roll Bounce,10000000,17380866,17433072,7433072,0.743307
11/8/2019,The Good Liar,10000000,17156058,33216217,23216217,2.32162
12/11/1998,Rushmore,10000000,17105219,19080435,9080435,0.908044
1/19/1990,Tremors,10000000,16667084,16667084,6667084,0.666708
6/17/2005,The Perfect Man,10000000,16535005,19535005,9535005,0.9535
8/3/1990,Mo' Better Blues,10000000,16153000,16153000,6153000,0.6153
1/25/2002,Kung Pow: Enter the Fist,10000000,16033556,17033556,7033556,0.703356
10/7/2016,The Birth of a Nation,10000000,15861566,16891011,6891011,0.689101
4/2/2021,The Unholy,10000000,15530440,30829485,20829485,2.08295
5/30/2003,Wrong Turn,10000000,15417771,28649556,18649556,1.86496
5/16/1980,The Long Riders,10000000,15198912,15198912,5198912,0.519891
3/12/1999,The Corruptor,10000000,15164492,15164492,5164492,0.516449
8/14/2009,The Goods: Live Hard Sell Hard,10000000,15122676,15297318,5297318,0.529732
11/23/2011,My Week with Marilyn,10000000,14597405,34240572,24240572,2.42406
12/25/2014,Big Eyes,10000000,14482031,27317872,17317872,1.73179
8/5/2005,Broken Flowers,10000000,13744960,40744960,30744960,3.0745
6/28/2002,Hey Arnold! The Movie,10000000,13684949,13684949,3684949,0.368495
5/10/2019,Poms,10000000,13631124,16463241,6463241,0.646324
2/20/2020,Brahms: The Boy II,10000000,12611536,18976477,8976477,0.897648
12/30/2005,The Matador,10000000,12589255,17300838,7300838,0.730084
3/14/1997,Love Jones,10000000,12554569,12554569,2554569,0.255457
12/19/2000,The Gift,10000000,12008642,44567606,34567606,3.45676
1/20/2006,End of the Spear,10000000,11748661,11924041,1924041,0.192404
3/9/2001,Get Over It,10000000,11560259,19860259,9860259,0.986026
10/20/2000,The Legend of Drunken Master,10000000,11546543,11546543,1546543,0.154654
2/19/1999,Office Space,10000000,10827813,12179708,2179708,0.217971
6/23/2017,The Beguiled,10000000,10576669,28039038,18039038,1.8039
7/23/1999,Drop Dead Gorgeous,10000000,10571408,10571408,571408,0.0571408
4/5/2019,The Best of Enemies,10000000,10205616,10268749,268749,0.0268749
4/3/1998,The Spanish Prisoner,10000000,10162034,13835130,3835130,0.383513
2/13/2020,Emma.,10000000,10055355,26447347,16447347,1.64473
6/11/1999,Le Violon rouge,10000000,10019109,10019109,19109,0.0019109
11/25/1998,Very Bad Things,10000000,9949470,21094974,11094974,1.1095
7/9/2004,Sleepover,10000000,9408183,9424052,-575948,-0.0575948
2/8/2012,Movie 43,10000000,8840453,31164747,21164747,2.11647
10/19/2018,Can You Ever Forgive Me?,10000000,8803865,12517379,2517379,0.251738
10/26/1984,Body Double,10000000,8801940,8801940,-1198060,-0.119806
5/21/2010,MacGruber,10000000,8525600,8629895,-1370105,-0.137011
7/18/2003,Dirty Pretty Things,10000000,8112414,14156753,4156753,0.415675
3/14/2014,Bad Words,10000000,7779614,7843145,-2156855,-0.215686
3/27/2015,While We're Young,10000000,7582065,17503828,7503828,0.750383
2/1/2008,Over Her Dead Body,10000000,7570127,21596074,11596074,1.15961
10/24/2001,Bones,10000000,7316658,8378853,-1621147,-0.162115
6/22/2012,Seeking a Friend for the End of the World,10000000,7078738,11766959,1766959,0.176696
12/1/2006,Turistas,10000000,7027762,14321070,4321070,0.432107
3/17/2016,Shut In,10000000,6900335,11360665,1360665,0.136067
2/11/2011,Cedar Rapids,10000000,6861102,7862131,-2137869,-0.213787
11/29/2012,The Collection,10000000,6810754,8890094,-1109906,-0.110991
8/8/2018,Dog Days,10000000,6809080,8196226,-1803774,-0.180377
10/30/1998,American History X,10000000,6719864,6719864,-3280136,-0.328014
8/16/2018,A.X.L.,10000000,6501381,8259753,-1740247,-0.174025
1/16/2004,Teacher's Pet: The Movie,10000000,6491969,6491969,-3508031,-0.350803
10/15/1999,The Straight Story,10000000,6197866,6199310,-3800690,-0.380069
5/3/2002,Deuces Wild,10000000,6044618,6244618,-3755382,-0.375538
3/28/2008,Run Fatboy Run,10000000,6003262,33512260,23512260,2.35123
12/18/1981,Heartbeeps,10000000,6000000,6000000,-4000000,-0.4
3/20/2015,Danny Collins,10000000,5637066,8465845,-1534155,-0.153416
7/4/2007,Rescue Dawn,10000000,5490423,7037886,-2962114,-0.296211
12/28/2018,Stan & Ollie,10000000,5470235,29062674,19062674,1.90627
4/5/2000,Black and White,10000000,5241315,5241315,-4758685,-0.475869
6/18/2010,Io sono l’amore,10000000,5005465,15121528,5121528,0.512153
12/19/1986,King Kong Lives,10000000,4711220,4711220,-5288780,-0.528878
10/18/2019,Jay and Silent Bob Reboot,10000000,4589490,4710507,-5289493,-0.528949
8/9/2019,Brian Banks,10000000,4376820,4376820,-5623180,-0.562318
10/26/2001,On the Line,10000000,4365455,16222303,6222303,0.62223
6/15/2018,Gotti,10000000,4286367,6601992,-3398008,-0.339801
3/16/2012,Jeff Who Lives at Home,10000000,4269426,4708127,-5291873,-0.529187
9/30/2016,Denial,10000000,4073448,9263940,-736060,-0.073606
3/11/2016,The Man Who Knew Infinity,10000000,3877922,12382122,2382122,0.238212
10/14/2016,Max Steel,10000000,3818664,4563080,-5436920,-0.543692
3/30/2016,Everybody Wants Some,10000000,3400278,5437126,-4562874,-0.456287
10/4/1996,Crash,10000000,3357324,3412380,-6587620,-0.658762
10/12/2012,Atlas Shrugged: Part II,10000000,3336053,3336053,-6663947,-0.666395
2/4/1994,Romeo Is Bleeding,10000000,3275585,3275585,-6724415,-0.672442
10/8/1999,The Limey,10000000,3193102,6030047,-3969953,-0.396995
11/14/2014,Rosewater,10000000,3128941,3185717,-6814283,-0.681428
12/22/2000,The House of Mirth,10000000,3041803,5149131,-4850869,-0.485087
5/1/1987,Malone,10000000,3000000,3000000,-7000000,-0.7
6/2/2006,Peaceful Warrior,10000000,2893666,3260179,-6739821,-0.673982
9/9/2011,Bucky Larson: Born to Be a Star,10000000,2529395,2529395,-7470605,-0.747061
9/16/2016,Hillsong: Let Hope Rise,10000000,2394725,2678525,-7321475,-0.732147
10/6/2000,Bamboozled,10000000,2185266,2373937,-7626063,-0.762606
2/11/1981,Sphinx,10000000,2000000,11400000,1400000,0.14
5/3/2013,The Iceman,10000000,1930282,3623609,-6376391,-0.637639
1/16/2015,Testament of Youth,10000000,1822250,6646669,-3353331,-0.335333
3/31/2017,Free Fire,10000000,1799322,3793739,-6206261,-0.620626
6/24/2011,A Better Life,10000000,1759252,1884251,-8115749,-0.811575
2/28/2003,Spider,10000000,1641788,1641788,-8358212,-0.835821
2/4/2000,Gun Shy,10000000,1638202,1638202,-8361798,-0.83618
12/27/2002,Nicholas Nickleby,10000000,1562800,3311924,-6688076,-0.668808
4/16/2010,The Joneses,10000000,1475746,3541565,-6458435,-0.645844
6/23/2006,Krrish,10000000,1430721,32430721,22430721,2.24307
6/29/2012,Killer Joe,10000000,1291645,4659110,-5340890,-0.534089
3/30/2017,Churchill,10000000,1279681,7582196,-2417804,-0.24178
8/11/2000,Cecil B. Demented,10000000,1276984,1953882,-8046118,-0.804612
3/21/2014,50 to 1,10000000,1069454,1069454,-8930546,-0.893055
5/2/2003,Owning Mahowny,10000000,1011054,1147871,-8852129,-0.885213
10/19/2007,The Ten Commandments,10000000,952820,1051907,-8948093,-0.894809
9/7/2007,The Brothers Solomon,10000000,900926,900926,-9099074,-0.909907
4/4/2008,My Blueberry Nights,10000000,866778,22198996,12198996,1.2199
8/6/1999,Illuminata,10000000,836641,836641,-9163359,-0.916336
1/20/2012,Coriolanus,10000000,749641,2536707,-7463293,-0.746329
1/22/2021,Our Friend,10000000,657351,714095,-9285905,-0.92859
10/4/2013,Parkland,10000000,641439,1616353,-8383647,-0.838365
10/11/2002,Swept Away,10000000,598645,611032,-9388968,-0.938897
5/23/2008,War Inc.,10000000,580862,1299855,-8700145,-0.870015
4/2/2004,Shaolin Soccer,10000000,488872,42776032,32776032,3.2776
8/27/2004,The Brown Bunny,10000000,366301,630427,-9369573,-0.936957
9/14/2007,King of California,10000000,268461,1165102,-8834898,-0.88349
10/24/1997,Rien ne va plus,10000000,245359,5045359,-4954641,-0.495464
8/14/1998,La femme de chambre du Titanic,10000000,244465,244465,-9755535,-0.975553
12/17/2004,Imaginary Heroes,10000000,228524,290875,-9709125,-0.970912
7/20/2001,High Heels and Low Lifes,10000000,226792,2151098,-7848902,-0.78489
8/21/2009,World's Greatest Dad,10000000,221805,295750,-9704250,-0.970425
5/3/2013,Cinco de Mayo La Batalla,10000000,173472,173472,-9826528,-0.982653
10/29/2010,Welcome to the Rileys,10000000,152857,355919,-9644081,-0.964408
9/9/2016,Kicks,10000000,150191,150191,-9849809,-0.984981
10/9/2009,Free Style,10000000,141108,721108,-9278892,-0.927889
6/1/2012,High School,10000000,139034,248133,-9751867,-0.975187
5/18/2007,Severance,10000000,137221,5950002,-4049998,-0.405
7/14/2006,Edmond,10000000,131719,241719,-9758281,-0.975828
4/23/2010,Joheunnom nabbeunnom isanghannom,10000000,128486,42226657,32226657,3.22267
8/26/1994,Police Academy 7: Mission to Moscow,10000000,126247,126247,-9873753,-0.987375
2/19/2010,Blood Done Sign My Name,10000000,109383,109383,-9890617,-0.989062
2/19/2010,The Good Guy,10000000,100688,106460,-9893540,-0.989354
10/23/2009,Motherhood,10000000,93388,723388,-9276612,-0.927661
10/15/2004,Eulogy,10000000,70527,91201,-9908799,-0.99088
11/7/2014,Elsa & Fred,10000000,67657,197901,-9802099,-0.98021
3/18/2011,Alabama Moon,10000000,47305,47305,-9952695,-0.99527
2/27/1998,An Alan Smithee Film: Burn Hollywood Burn,10000000,45779,45779,-9954221,-0.995422
8/28/2009,The Open Road,10000000,19716,19716,-9980284,-0.998028
6/11/2015,Strangerland,10000000,17472,161097,-9838903,-0.98389
3/13/2015,Hross i oss,10000000,11894,11894,-9988106,-0.998811
10/16/2009,Janky Promoters,10000000,9069,9069,-9990931,-0.999093
12/21/2007,Blonde Ambition,10000000,6422,1537479,-8462521,-0.846252
8/6/2010,The Oxford Murders,10000000,4803,17704131,7704131,0.770413
7/25/2014,Barbecue,10000000,388,247565,-9752435,-0.975244
12/27/2018,T-34,10000000,0,39526616,29526616,2.95266
,The Reef,10000000,0,15037867,5037867,0.503787
1/8/2008,White Noise 2: The Light,10000000,0,8243567,-1756433,-0.175643
11/7/2014,Jessabelle,10000000,0,6998359,-3001641,-0.300164
1/23/2015,American Heist,10000000,0,2341218,-7658782,-0.765878
10/8/2010,It's a Wonderful Afterlife,10000000,0,1642939,-8357061,-0.835706
6/21/2011,You Got Served: Beat The World,10000000,0,1230542,-8769458,-0.876946
8/21/2009,Fifty Dead Men Walking,10000000,0,997921,-9002079,-0.900208
6/19/2014,Plastic,10000000,0,575371,-9424629,-0.942463
5/12/2017,Message from the King,10000000,0,391845,-9608155,-0.960816
2/7/2014,Nurse 3D,10000000,0,379584,-9620416,-0.962042
3/10/2015,Jungle Shuffle,10000000,0,360898,-9639102,-0.96391
10/28/2016,Ethel & Ernest,10000000,0,200447,-9799553,-0.979955
9/22/2009,Adam Resurrected,10000000,0,90909,-9909091,-0.990909
11/17/2017,Mudbound,10000000,0,53559,-9946441,-0.994644
5/26/2009,The Devil's Tomb,10000000,0,0,-10000000,-1
,Good Intentions,10000000,0,0,-10000000,-1
2/2/2007,Partition,10000000,0,0,-10000000,-1
4/13/2012,Detention,10000000,0,0,-10000000,-1
5/19/2015,Grizzly,10000000,0,0,-10000000,-1
1/19/2018,Step Sisters,10000000,0,0,-10000000,-1
2/16/2018,Irreplaceable You,10000000,0,0,-10000000,-1
1/7/2016,Friend Request,9900000,3759078,11310835,1410835,0.142509
4/30/2010,Gunless,9900000,458054,458054,-9441946,-0.953732
4/3/2009,Adventureland,9800000,16044025,17553055,7753055,0.791128
9/20/2012,Amour,9700000,6738954,36787044,27087044,2.79248
10/16/2015,Truth,9600000,2541854,6842580,-2757420,-0.287231
4/28/2006,The Lost City,9600000,2484186,5256839,-4343161,-0.452413
1/12/2000,Next Friday,9500000,57176582,59675307,50175307,5.28161
6/13/2067,You Only Live Twice,9500000,43100000,111600000,102100000,10.7474
6/10/1988,Poltergeist III,9500000,14114000,14114000,4614000,0.485684
12/21/2016,Dangal,9500000,12391761,305149461,295649461,31.121
3/19/2010,The Runaways,9500000,3573673,5278632,-4221368,-0.444355
10/30/2009,Gentlemen Broncos,9500000,115155,119955,-9380045,-0.987373
